종목명,분기,기업코드,유동자산,부채총계,청산가치
지놈앤컴퍼니,2021년 1분기 보고서,01276026,99444117279,5760122962,93683994317
웹젠,2021년 1분기 보고서,00405320,314276519067,94382174001,219894345066
우리넷,2021년 1분기 보고서,00664048,74625085569,37563510513,37061575056
마이크로디지탈,2021년 1분기 보고서,01267967,9950472707,10294936016,-344463309
나노,2021년 1분기 보고서,00994994,28248401252,27111418730,1136982522
손오공,2021년 1분기 보고서,00306870,29146591971,16129794502,13016797469
새로닉스,2021년 1분기 보고서,00147994,18118292184,38307850915,-20189558731
피씨디렉트,2021년 1분기 보고서,00297934,82359213054,43373420759,38985792295
케이엠제약,2021년 1분기 보고서,01095704,12922269436,15139792736,-2217523300
로보로보,2021년 1분기 보고서,01063990,14444134397,970676611,13473457786
DSR제강,2021년 1분기 보고서,00151298,87121944467,64008526208,23113418259
아이비김영,2021년 1분기 보고서,01414422,15738746337,25935889052,-10197142715
한국정밀기계,2021년 1분기 보고서,00257732,51275725675,30526792225,20748933450
비비씨,2021년 1분기 보고서,01153105,28828621011,3789795411,25038825600
삼기,2021년 1분기 보고서,00799177,146108875018,288903971057,-142795096039
유나이티드,2021년 1분기 보고서,00158963,194670977157,85448895356,109222081801
지니언스,2021년 1분기 보고서,00962223,27070846233,7706268189,19364578044
파라텍,2021년 1분기 보고서,00105138,65183491466,53192442179,11991049287
예스코홀딩스,2021년 1분기 보고서,00105101,225192404000,138203978000,86988426000
시노펙스,2021년 1분기 보고서,00203023,49666048699,61163433967,-11497385268
모나리자,2021년 1분기 보고서,00173102,35914997626,20727599894,15187397732
티웨이홀딩스,2021년 1분기 보고서,00109514,14899954895,43525168751,-28625213856
씨앤지하이테크,2021년 1분기 보고서,00605328,62199444980,15711865365,46487579615
삼화왕관,2021년 1분기 보고서,00129235,46300735991,86977147479,-40676411488
백산,2021년 1분기 보고서,00122551,119465079925,119264124737,200955188
피엔에이치테크,2021년 1분기 보고서,01112889,20438949135,12471244868,7967704267
하림지주,2021년 1분기 보고서,00148364,66403117423,683022735689,-616619618266
에스코넥,2021년 1분기 보고서,00573269,49052861270,61486649974,-12433788704
삼성제약,2021년 1분기 보고서,00126414,93677734577,15553106086,78124628491
화인베스틸,2021년 1분기 보고서,00661847,60064054646,97633646535,-37569591889
퓨쳐스트림네트웍스,2021년 1분기 보고서,01061497,24712589984,69231664093,-44519074109
아모텍,2021년 1분기 보고서,00298447,148549361419,251924863210,-103375501791
삼영이엔씨,2021년 1분기 보고서,00288343,65474955273,25342065446,40132889827
선진뷰티사이언스,2021년 1분기 보고서,00132202,39152027121,54341180251,-15189153130
SK케미칼,2021년 1분기 보고서,01267170,961589928258,911780391090,49809537168
코리아센터,2021년 1분기 보고서,00540340,243591249508,7524598900,236066650608
대상홀딩스,2021년 1분기 보고서,00539274,34502253680,23683531571,10818722109
TJ미디어,2021년 1분기 보고서,00201733,28802127303,27834857612,967269691
애니젠,2021년 1분기 보고서,00808086,10674365573,19463219749,-8788854176
엠투아이,2021년 1분기 보고서,00670766,40383119188,11945674738,28437444450
에스씨엠생명과학,2021년 1분기 보고서,01110474,31906316926,14105303917,17801013009
이트론,2021년 1분기 보고서,00480756,34531033838,15394513927,19136519911
이녹스첨단소재,2021년 1분기 보고서,01237540,206715142179,138825429538,67889712641
바이오리더스,2021년 1분기 보고서,00587925,57051593478,-110421276677,167472870155
화천기계,2021년 1분기 보고서,00166500,72798529988,35699714719,37098815269
원익머트리얼즈,2021년 1분기 보고서,00623661,111960733737,31168680955,80792052782
멜파스,2021년 1분기 보고서,00609315,15127296196,31549117084,-16421820888
부광약품,2021년 1분기 보고서,00123718,208869167891,105715997282,103153170609
케이티스카이라이프,2021년 1분기 보고서,00349097,411597075923,119554915000,292042160923
아바코,2021년 1분기 보고서,00442145,170331584856,90218586983,80112997873
미원화학,2021년 1분기 보고서,00855163,56600214410,27380704149,29219510261
차바이오텍,2021년 1분기 보고서,00525679,116494465111,157641693941,-41147228830
일진다이아,2021년 1분기 보고서,00508274,91179002730,27206391894,63972610836
티와이홀딩스,2021년 1분기 보고서,01497869,13973583805,24574701367,-10601117562
엑시콘,2021년 1분기 보고서,00611736,52692046066,21045142057,31646904009
중앙백신,2021년 1분기 보고서,00415327,46128966675,25614463274,20514503401
팜스빌,2021년 1분기 보고서,00986898,27018946523,3964669000,23054277523
SG&G,2021년 1분기 보고서,00264714,11045280012,49219244745,-38173964733
동일고무벨트,2021년 1분기 보고서,00939687,161881838200,90545915410,71335922790
이미지스,2021년 1분기 보고서,00694942,8622189482,2598050665,6024138817
성도이엔지,2021년 1분기 보고서,00216498,146184116381,135460638540,10723477841
한국맥널티,2021년 1분기 보고서,00579139,29438836861,22411686431,7027150430
육일씨엔에쓰,2021년 1분기 보고서,00843900,22533565511,33050956429,-10517390918
바다로19호,2021년 1분기 보고서,00910947,3800962871,3213657210,587305661
사람인에이치알,2021년 1분기 보고서,00857480,63274743105,5829631500,57445111605
퀀타매트릭스,2021년 1분기 보고서,01311286,49559101673,4617907919,44941193754
압타바이오,2021년 1분기 보고서,01251595,46300302026,3741866730,42558435296
위드텍,2021년 1분기 보고서,00925587,96433952560,29318455389,67115497171
아프리카TV,2021년 1분기 보고서,00399694,210819796207,150380102880,60439693327
심텍홀딩스,2021년 1분기 보고서,00152127,4782290777,11485092638,-6702801861
심텍,2021년 1분기 보고서,01095722,188844768849,446674170948,-257829402099
솔트룩스,2021년 1분기 보고서,01050738,29068700646,2540457500,26528243146
팬엔터테인먼트,2021년 1분기 보고서,00397191,27017395684,35962030083,-8944634399
솔루엠,2021년 1분기 보고서,01159233,199727393063,104828281366,94899111697
셀트리온헬스케어,2021년 1분기 보고서,00554024,3227041904765,1500650225233,1726391679532
OQP,2021년 1분기 보고서,00230814,39137733125,327923185216,-288785452091
노루홀딩스,2021년 1분기 보고서,00113508,71325129018,66292803546,5032325472
라온피플,2021년 1분기 보고서,01251489,58248670165,5677043834,52571626331
브릿지바이오,2021년 1분기 보고서,01227039,50137745651,5373968168,44763777483
파미셀,2021년 1분기 보고서,00145163,45092920934,13295396068,31797524866
아이앤씨,2021년 1분기 보고서,00365758,20286615012,13424817389,6861797623
에스엠코어,2021년 1분기 보고서,00137915,67043236376,19652023763,47391212613
라닉스,2021년 1분기 보고서,01327092,5886160314,14872806179,-8986645865
코미코,2021년 1분기 보고서,00997812,51874768622,68318153873,-16443385251
네오크레마,2021년 1분기 보고서,01219155,23929554503,8646956622,15282597881
모트렉스,2021년 1분기 보고서,00876908,99964896362,129294025881,-29329129519
에스티오,2021년 1분기 보고서,00612188,44001085054,40195703147,3805381907
OCI,2021년 1분기 보고서,00148896,870483721000,1048755548000,-178271827000
텔레칩스,2021년 1분기 보고서,00423177,96746879622,87621866242,9125013380
HRS,2021년 1분기 보고서,00230911,35121254048,12941197222,22180056826
덕성,2021년 1분기 보고서,00114093,57979604698,39021230628,18958374070
성문전자,2021년 1분기 보고서,00132628,12015357684,6030699588,5984658096
한국유니온제약,2021년 1분기 보고서,00532855,41571724197,29026410227,12545313970
넥센타이어,2021년 1분기 보고서,00173874,895698224605,1107955135671,-212256911066
KG케미칼,2021년 1분기 보고서,00101220,78937129870,144950467258,-66013337388
도이치모터스,2021년 1분기 보고서,00449379,141670263763,319867865730,-178197601967
PI첨단소재,2021년 1분기 보고서,00767460,158623906644,138360286964,20263619680
한국철강,2021년 1분기 보고서,00687711,533441189966,171045532864,362395657102
KISCO홀딩스,2021년 1분기 보고서,00159740,100195456578,5128968615,95066487963
핑거,2021년 1분기 보고서,01142075,35618648716,12898960001,22719688715
보령제약,2021년 1분기 보고서,00123143,321605522940,307076290747,14529232193
큐리언트,2021년 1분기 보고서,01042650,4200953628,5762492000,-1561538372
송원산업,2021년 1분기 보고서,00134963,331046000000,398345000000,-67299000000
메디아나,2021년 1분기 보고서,00273439,54371078348,10961816414,43409261934
와이엠씨,2021년 1분기 보고서,00870861,65172735302,26367226270,38805509032
예선테크,2021년 1분기 보고서,01166109,21548901154,26798433132,-5249531978
티에스아이,2021년 1분기 보고서,01139035,40123513576,24310586384,15812927192
마이크로프랜드,2021년 1분기 보고서,00654175,37145501193,19628003290,17517497903
서플러스글로벌,2021년 1분기 보고서,00599285,136210218468,112565727824,23644490644
코스모신소재,2021년 1분기 보고서,00129989,140531066424,174721999512,-34190933088
메디톡스,2021년 1분기 보고서,00580199,111446897091,206081692628,-94634795537
대한제강,2021년 1분기 보고서,00113225,312283436976,206928098648,105355338328
하나제약,2021년 1분기 보고서,00248974,150713339575,53761883136,96951456439
롯데지주,2021년 1분기 보고서,00120562,7243087224951,21179372000,7221907852951
GS리테일,2021년 1분기 보고서,00140177,912680395755,3331876105001,-2419195709246
서연,2021년 1분기 보고서,00163114,28628817961,5911875714,22716942247
한일네트웍스,2021년 1분기 보고서,00277736,50840438098,62124921795,-11284483697
인지디스플레,2021년 1분기 보고서,00265421,71137585368,187141606712,-116004021344
위세아이텍,2021년 1분기 보고서,00374738,24550753655,15268362568,9282391087
동양피스톤,2021년 1분기 보고서,00117726,124748259368,185142796532,-60394537164
클리오,2021년 1분기 보고서,00957735,124378185282,80060143527,44318041755
라이온켐텍,2021년 1분기 보고서,00317104,68316176843,30306549065,38009627778
SK텔레콤,2021년 1분기 보고서,00159023,5017246000000,14507580000000,-9490334000000
옴니시스템,2021년 1분기 보고서,00265005,53181682062,19058962733,34122719329
인터지스,2021년 1분기 보고서,00151368,172081287814,175986761520,-3905473706
CJ씨푸드,2021년 1분기 보고서,00129013,47859278123,66687750816,-18828472693
올릭스,2021년 1분기 보고서,01113718,15216732004,6851580000,8365152004
쿠쿠홀딩스,2021년 1분기 보고서,00132354,50523832741,69738723887,-19214891146
무림P&P,2021년 1분기 보고서,00119007,1152121146636,566122238033,585998908603
인바이오,2021년 1분기 보고서,00367871,61983823368,36113297506,25870525862
펄어비스,2021년 1분기 보고서,01152470,431347602052,6617800000,424729802052
진성티이씨,2021년 1분기 보고서,00174208,127876999137,74053289443,53823709694
SDN,2021년 1분기 보고서,00574611,55251190324,60377419446,-5126229122
신도기연,2021년 1분기 보고서,00961570,49307714235,19364998277,29942715958
로보티즈,2021년 1분기 보고서,00946030,47269492962,10702046798,36567446164
피씨엘,2021년 1분기 보고서,01051092,104731481987,88601502429,16129979558
코리아에스이,2021년 1분기 보고서,00527491,19394045863,5486543041,13907502822
한국콜마,2021년 1분기 보고서,00939331,391429619614,411312864536,-19883244922
카페24,2021년 1분기 보고서,00260879,59128313197,65559754372,-6431441175
스카이문스테크놀로지,2021년 1분기 보고서,00276083,14560569896,6329397436,8231172460
핸즈코퍼레이션,2021년 1분기 보고서,00119140,252137228368,296726908698,-44589680330
브이원텍,2021년 1분기 보고서,01027794,66508459543,28141923113,38366536430
코세스,2021년 1분기 보고서,00365934,31083585952,37662283360,-6578697408
애경산업,2021년 1분기 보고서,00139454,269679072200,123877713929,145801358271
노터스,2021년 1분기 보고서,01189438,19506518342,17764694956,1741823386
슈프리마에이치큐,2021년 1분기 보고서,00599957,45886882469,7198784327,38688098142
엘이티,2021년 1분기 보고서,00523936,48350830212,18764463709,29586366503
휴네시온,2021년 1분기 보고서,01251577,14728796188,4256001295,10472794893
SK네트웍스,2021년 1분기 보고서,00131780,2039076000000,3850968000000,-1811892000000
하나금융16호스팩,2021년 1분기 보고서,01419384,8320983210,940959439,7380023771
파워넷,2021년 1분기 보고서,00231354,76949524211,62520991460,14428532751
창해에탄올,2021년 1분기 보고서,00123523,40376300057,48675545491,-8299245434
CS홀딩스,2021년 1분기 보고서,00149026,39606071548,8284323221,31321748327
조선선재,2021년 1분기 보고서,00796994,109811981669,12285388035,97526593634
현대글로비스,2021년 1분기 보고서,00360595,4999573415732,5334492238418,-334918822686
조광피혁,2021년 1분기 보고서,00148939,103402916130,35169952395,68232963735
KPX케미칼,2021년 1분기 보고서,00191472,624300017938,441861343681,182438674257
디케이티,2021년 1분기 보고서,01137903,40922571320,7979440962,32943130358
세종공업,2021년 1분기 보고서,00134510,359891800446,350019195071,9872605375
파트론,2021년 1분기 보고서,00490151,313430379232,232760774746,80669604486
박셀바이오,2021년 1분기 보고서,01335851,18486430287,600273127,17886157160
KC그린홀딩스,2021년 1분기 보고서,00159971,134086537848,11217490000,122869047848
모바일어플라이언스,2021년 1분기 보고서,00556615,54431880603,33741684826,20690195777
코퍼스코리아,2021년 1분기 보고서,01364297,41041659327,21525227413,19516431914
세아제강,2021년 1분기 보고서,01325979,552486156052,512202489716,40283666336
신원,2021년 1분기 보고서,00136864,281803709589,253387355897,28416353692
덕신하우징,2021년 1분기 보고서,00454937,73050522504,70676228061,2374294443
인천도시가스,2021년 1분기 보고서,00145862,210106982153,212815889456,-2708907303
액트로,2021년 1분기 보고서,01141942,53257214161,6055836562,47201377599
신풍제약,2021년 1분기 보고서,00137359,305669427353,99471296387,206198130966
하나머스트제6호스팩,2021년 1분기 보고서,01326260,9111152284,748108299,8363043985
한솔피엔에스,2021년 1분기 보고서,00103626,92179359461,65328114324,26851245137
SKC,2021년 1분기 보고서,00139889,311163095040,1047079679557,-735916584517
대창스틸,2021년 1분기 보고서,00112721,104011806748,154375166200,-50363359452
에스티아이,2021년 1분기 보고서,00298340,117882679483,51581472633,66301206850
디오,2021년 1분기 보고서,00115931,159061589386,122253272623,36808316763
한독크린텍,2021년 1분기 보고서,01069736,26530959325,8127234819,18403724506
KMH,2021년 1분기 보고서,00657987,226888757632,144961991903,81926765729
그리티,2021년 1분기 보고서,00671978,58878632710,11807380166,47071252544
지에스이,2021년 1분기 보고서,00351995,35511595850,95872564927,-60360969077
모두투어,2021년 1분기 보고서,00456218,91008544840,79353139722,11655405118
와이아이케이,2021년 1분기 보고서,01109539,239437997719,104627319505,134810678214
자비스,2021년 1분기 보고서,01174038,13722947139,19777478534,-6054531395
유니크,2021년 1분기 보고서,00147152,89131341938,110363484690,-21232142752
아이큐어,2021년 1분기 보고서,00554352,61764795245,111643296670,-49878501425
NICE평가정보,2021년 1분기 보고서,00158325,166783380561,100088504537,66694876024
제노레이,2021년 1분기 보고서,00799539,62110609587,20449783860,41660825727
대봉엘에스,2021년 1분기 보고서,00442826,53519024086,14410667232,39108356854
한세엠케이,2021년 1분기 보고서,00357360,83577612125,46533901175,37043710950
솔본,2021년 1분기 보고서,00249982,15799980116,3037200864,12762779252
세아베스틸,2021년 1분기 보고서,00106669,711252557623,958689206765,-247436649142
유니드,2021년 1분기 보고서,00159786,281430601080,288573649475,-7143048395
CJ,2021년 1분기 보고서,00148540,96918907000,463899154000,-366980247000
상신전자,2021년 1분기 보고서,00760999,41818224837,22360957087,19457267750
태경산업,2021년 1분기 보고서,00153339,43204189135,27593860623,15610328512
쎄니트,2021년 1분기 보고서,00239596,33615496802,48547147646,-14931650844
중앙에너비스,2021년 1분기 보고서,00149770,20733936972,9454978643,11278958329
루트로닉,2021년 1분기 보고서,00549925,124584019969,63597007086,60987012883
KCC건설,2021년 1분기 보고서,00105466,632694283875,600522472737,32171811138
하이즈항공,2021년 1분기 보고서,00688358,48130222588,61411818661,-13281596073
에프앤가이드,2021년 1분기 보고서,00331016,24981333387,14236981875,10744351512
서전기전,2021년 1분기 보고서,00869272,22735464158,15301019438,7434444720
비에이치,2021년 1분기 보고서,00447609,278535043925,150509548291,128025495634
메디앙스,2021년 1분기 보고서,00267854,30630303411,56098190222,-25467886811
에프알텍,2021년 1분기 보고서,00442561,10203419864,26763641697,-16560221833
NHN한국사이버결제,2021년 1분기 보고서,00357740,303644847420,229476200042,74168647378
오로라,2021년 1분기 보고서,00141556,61532282467,132981602222,-71449319755
구영테크,2021년 1분기 보고서,00202060,42772921605,89366999615,-46594078010
큐브앤컴퍼니,2021년 1분기 보고서,00351454,14893105846,1121256756,13771849090
대성미생물,2021년 1분기 보고서,00177320,22686555466,25451029585,-2764474119
하나투어,2021년 1분기 보고서,00269940,222793150163,6969592500,215823557663
에이치엘비생명과학,2021년 1분기 보고서,00365590,101756349141,22564718788,79191630353
시티랩스,2021년 1분기 보고서,00656021,16153572050,35639643939,-19486071889
키네마스터,2021년 1분기 보고서,00535375,11348621942,1914493304,9434128638
지더블유바이텍,2021년 1분기 보고서,00257149,29244885882,20561424394,8683461488
에이트원,2021년 1분기 보고서,01110076,21862960387,13338734734,8524225653
비씨월드제약,2021년 1분기 보고서,00256043,50321500179,57744603675,-7423103496
진바이오텍,2021년 1분기 보고서,00491053,21537595375,5666665180,15870930195
엔피케이,2021년 1분기 보고서,00108490,18655887280,32585689168,-13929801888
티엘아이,2021년 1분기 보고서,00261887,20894166969,5938421552,14955745417
유니셈,2021년 1분기 보고서,00260569,156674394938,54826462128,101847932810
LG전자,2021년 1분기 보고서,00401731,9546983000000,19734747000000,-10187764000000
에스에너지,2021년 1분기 보고서,00585538,91214457791,75437129391,15777328400
지란지교시큐리티,2021년 1분기 보고서,01047169,15291648319,17994383541,-2702735222
LG하우시스,2021년 1분기 보고서,00759513,897846000000,1254305000000,-356459000000
윌링스,2021년 1분기 보고서,00863038,26990706436,8795693126,18195013310
셀트리온,2021년 1분기 보고서,00413046,2419272183592,1320087495118,1099184688474
하이트진로,2021년 1분기 보고서,00150244,1330119863169,2615413275647,-1285293412478
하이트진로홀딩스,2021년 1분기 보고서,00148993,27807397021,625290552876,-597483155855
현대일렉트릭,2021년 1분기 보고서,01205851,1247047389874,1316403139019,-69355749145
레고켐바이오,2021년 1분기 보고서,00842619,77761768256,20650210567,57111557689
LG상사,2021년 1분기 보고서,00120076,904117132581,1381413756694,-477296624113
엑스큐어,2021년 1분기 보고서,00683007,20239289000,1956268000,18283021000
태영건설,2021년 1분기 보고서,00153861,1596501048067,1846759287861,-250258239794
현대약품,2021년 1분기 보고서,00164706,78015382067,67322744899,10692637168
와이팜,2021년 1분기 보고서,01015160,72263041050,19262975341,53000065709
쎄노텍,2021년 1분기 보고서,01091054,26890723881,52919515015,-26028791134
대원화성,2021년 1분기 보고서,00112022,49697414427,61380313585,-11682899158
삼천리,2021년 1분기 보고서,00128555,1348674851646,1800423118971,-451748267325
포스코인터내셔널,2021년 1분기 보고서,00124504,5018950641000,5262116342000,-243165701000
와이제이엠게임즈,2021년 1분기 보고서,01035678,8164281336,12714756480,-4550475144
클라우드에어,2021년 1분기 보고서,00232821,66017303118,19069818276,46947484842
케어랩스,2021년 1분기 보고서,01187148,72188653627,8715799000,63472854627
인산가,2021년 1분기 보고서,01243161,27505678308,30920314738,-3414636430
세종메디칼,2021년 1분기 보고서,00959229,18356685965,2448250997,15908434968
동아타이어,2021년 1분기 보고서,01262458,94423366837,26955705595,67467661242
알에스오토메이션,2021년 1분기 보고서,00858124,48418503740,36457474375,11961029365
매커스,2021년 1분기 보고서,00596677,135379264358,94249563327,41129701031
GS,2021년 1분기 보고서,00500254,241726000000,1053922000000,-812196000000
LS,2021년 1분기 보고서,00105952,260992000000,345605000000,-84613000000
인바이오젠,2021년 1분기 보고서,00652423,126218712425,16832959386,109385753039
파버나인,2021년 1분기 보고서,00429694,30086449534,44472076283,-14385626749
삼양옵틱스,2021년 1분기 보고서,00992543,25627778821,15614386067,10013392754
영풍제지,2021년 1분기 보고서,00141404,78450842254,78358794790,92047464
엔비티,2021년 1분기 보고서,01051065,15220293228,848771300,14371521928
코오롱글로벌,2021년 1분기 보고서,00152880,1023980146535,1723803389959,-699823243424
동국S&C,2021년 1분기 보고서,00415594,165243444609,46132189118,119111255491
서울옥션,2021년 1분기 보고서,00410915,86208008728,88245336827,-2037328099
노루페인트,2021년 1분기 보고서,00583442,261817522969,312020183710,-50202660741
LG디스플레이,2021년 1분기 보고서,00105873,7729112000000,17116173000000,-9387061000000
동양철관,2021년 1분기 보고서,00117629,58706269235,50980681201,7725588034
레인보우로보틱스,2021년 1분기 보고서,01261644,30157922858,2169282808,27988640050
민앤지,2021년 1분기 보고서,01013311,46714704633,15925838214,30788866419
이엠네트웍스,2021년 1분기 보고서,00496225,17215304973,45624647960,-28409342987
큐브엔터,2021년 1분기 보고서,00985686,30127057836,17260365477,12866692359
슈펙스비앤피,2021년 1분기 보고서,00353018,36091130700,21013922561,15077208139
테고사이언스,2021년 1분기 보고서,00926522,27672799261,1063184970,26609614291
에스텍,2021년 1분기 보고서,00306719,108570933115,47072839162,61498093953
한일철강,2021년 1분기 보고서,00163196,66939746132,143029422184,-76089676052
클래시스,2021년 1분기 보고서,01061327,91434881324,19251981975,72182899349
앱클론,2021년 1분기 보고서,00991191,20447831416,11305281285,9142550131
크라운해태홀딩스,2021년 1분기 보고서,00153126,6135507394,61061110952,-54925603558
알톤스포츠,2021년 1분기 보고서,00821607,24608057712,5709962995,18898094717
고바이오랩,2021년 1분기 보고서,01399071,54940724746,1155677492,53785047254
신화콘텍,2021년 1분기 보고서,00925189,38950165312,40933979831,-1983814519
화일약품,2021년 1분기 보고서,00188973,98011402472,13395974964,84615427508
지어소프트,2021년 1분기 보고서,00389110,28806532074,37951937905,-9145405831
세아홀딩스,2021년 1분기 보고서,00377610,12172096795,141814435962,-129642339167
에스에이티,2021년 1분기 보고서,00379229,25345689690,5622212316,19723477374
동원산업,2021년 1분기 보고서,00118026,444920273043,897959439123,-453039166080
광동제약,2021년 1분기 보고서,00103592,388001418594,223038397606,164963020988
크라운제과,2021년 1분기 보고서,01205329,104953529060,176527613892,-71574084832
글로벌텍스프리,2021년 1분기 보고서,01042711,24788325682,9344332113,15443993569
케이엠,2021년 1분기 보고서,00242934,68425424919,44306994709,24118430210
티앤알바이오팹,2021년 1분기 보고서,01109937,38281002676,3409874344,34871128332
본느,2021년 1분기 보고서,01098792,22438563449,29810361048,-7371797599
대유,2021년 1분기 보고서,00384948,53282744985,32729060189,20553684796
ITX-AI,2021년 1분기 보고서,00627029,33219102689,25740895361,7478207328
DB하이텍,2021년 1분기 보고서,00160843,486062638366,365828280572,120234357794
코오롱플라스틱,2021년 1분기 보고서,00241005,132129215887,135597223674,-3468007787
레이언스,2021년 1분기 보고서,00899459,218053826441,99441615412,118612211029
HDC아이콘트롤스,2021년 1분기 보고서,00350312,188606345893,49860427448,138745918445
태원물산,2021년 1분기 보고서,00154055,23109774731,7658510244,15451264487
유니퀘스트,2021년 1분기 보고서,00414601,224495876597,149861133990,74634742607
에스에스알,2021년 1분기 보고서,01250374,20856821538,1951047319,18905774219
서진시스템,2021년 1분기 보고서,00838005,165766898978,271202668135,-105435769157
한국바이오젠,2021년 1분기 보고서,00876166,22181949778,4079770973,18102178805
제이브이엠,2021년 1분기 보고서,00361381,69684147461,34320404306,35363743155
BGF,2021년 1분기 보고서,00219097,400699711010,54932927011,345766783999
빅텍,2021년 1분기 보고서,00385363,90227863109,73944463285,16283399824
국제약품,2021년 1분기 보고서,00104722,52958635255,74480794727,-21522159472
한라,2021년 1분기 보고서,00161116,584093419686,976427374520,-392333954834
비상교육,2021년 1분기 보고서,00520887,103465829492,50903792209,52562037283
포인트모바일,2021년 1분기 보고서,00962393,63781123286,42341487777,21439635509
하나금융17호스팩,2021년 1분기 보고서,01493535,14586677257,1920668686,12666008571
우리기술,2021년 1분기 보고서,00231044,39489486793,55796730764,-16307243971
유엔젤,2021년 1분기 보고서,00416654,27953284612,8518533283,19434751329
한미반도체,2021년 1분기 보고서,00161383,209753660181,71732049235,138021610946
휴비스,2021년 1분기 보고서,00362238,334229924725,355866830401,-21636905676
한양디지텍,2021년 1분기 보고서,00488989,64361736646,68953630839,-4591894193
무림페이퍼,2021년 1분기 보고서,00136086,253221391833,551519882295,-298298490462
피에스케이,2021년 1분기 보고서,01365825,219512935494,63130202947,156382732547
대한전선,2021년 1분기 보고서,00113207,739915834000,895616643000,-155700809000
피플바이오,2021년 1분기 보고서,01118281,8422639524,2738694040,5683945484
동일금속,2021년 1분기 보고서,00118284,34332103024,12192673113,22139429911
네오펙트,2021년 1분기 보고서,01246034,14929842877,23702327177,-8772484300
메카로,2021년 1분기 보고서,00652007,53866058050,14833006742,39033051308
덕산네오룩스,2021년 1분기 보고서,01061558,101685366921,28287637556,73397729365
아시아경제,2021년 1분기 보고서,00665676,147262030012,109851239166,37410790846
씨앤투스성진,2021년 1분기 보고서,00875237,120912700245,28720807242,92191893003
메가스터디교육,2021년 1분기 보고서,01074862,154531539799,279793576499,-125262036700
RFHIC,2021년 1분기 보고서,01078178,202000049804,93476583513,108523466291
넥스틴,2021년 1분기 보고서,01080252,43809340828,6287807080,37521533748
알테오젠,2021년 1분기 보고서,00989619,174102818217,7436077207,166666741010
하이텍팜,2021년 1분기 보고서,00409964,46358645644,37874950002,8483695642
아이원스,2021년 1분기 보고서,00625942,51996346819,92468835527,-40472488708
덕산테코피아,2021년 1분기 보고서,01021666,66725199967,12910577671,53814622296
베셀,2021년 1분기 보고서,00813389,13820986984,26258722578,-12437735594
데이타솔루션,2021년 1분기 보고서,00877819,28692656456,17467613146,11225043310
엘오티베큠,2021년 1분기 보고서,00484682,123365062581,63005213914,60359848667
배럴,2021년 1분기 보고서,01182240,26579884512,8356604507,18223280005
대웅제약,2021년 1분기 보고서,00427483,424161101838,671658244502,-247497142664
에프엔씨엔터,2021년 1분기 보고서,00925295,33166561240,51412635838,-18246074598
디알젬,2021년 1분기 보고서,00966168,54562532247,20853215464,33709316783
하이스틸,2021년 1분기 보고서,00435312,89219715110,115953482299,-26733767189
슈프리마아이디,2021년 1분기 보고서,01231786,38006534825,3539851830,34466682995
휴온스,2021년 1분기 보고서,01159853,260962781057,167349038680,93613742377
케이피에스,2021년 1분기 보고서,01037214,48701005917,26110860628,22590145289
한전KPS,2021년 1분기 보고서,00159218,770464431539,335697316967,434767114572
디아이,2021년 1분기 보고서,00118275,83170739837,91144528733,-7973788896
한솔테크닉스,2021년 1분기 보고서,00157399,206341125851,213948166574,-7607040723
아이쓰리시스템,2021년 1분기 보고서,00612489,66236390383,42243300329,23993090054
고영,2021년 1분기 보고서,00579999,251597286511,67209126357,184388160154
핌스,2021년 1분기 보고서,01405390,37132647294,17492151042,19640496252
연우,2021년 1분기 보고서,00372253,99670541530,64914365440,34756176090
삼양패키징,2021년 1분기 보고서,01060814,140462000000,273852000000,-133390000000
금양,2021년 1분기 보고서,00106119,70268018283,120801851895,-50533833612
사조대림,2021년 1분기 보고서,00109718,280475137941,327704431654,-47229293713
헬릭스미스,2021년 1분기 보고서,00359395,276516620200,116679857422,159836762778
알로이스,2021년 1분기 보고서,01309795,26665826847,6496282569,20169544278
농심홀딩스,2021년 1분기 보고서,00459871,24479332764,14816094894,9663237870
조흥,2021년 1분기 보고서,00149345,132955985514,105320794809,27635190705
서흥,2021년 1분기 보고서,00131692,204917093084,228439978164,-23522885080
남화토건,2021년 1분기 보고서,00108001,60640105372,24468003932,36172101440
서암기계공업,2021년 1분기 보고서,00166528,54154856180,9768050798,44386805382
엔에이치엔,2021년 1분기 보고서,00983271,147040826864,96692717549,50348109315
하나금융15호스팩,2021년 1분기 보고서,01416457,10729672253,1536804486,9192867767
디앤씨미디어,2021년 1분기 보고서,01186404,51250042647,6267096986,44982945661
에스제이케이,2021년 1분기 보고서,00366793,5196451070,46093228483,-40896777413
대호에이엘,2021년 1분기 보고서,00428729,54878262151,78203145523,-23324883372
케이프,2021년 1분기 보고서,00152437,160501088017,15450864000,145050224017
엘엠에스,2021년 1분기 보고서,00494218,106726755463,102495508955,4231246508
제이에스코퍼레이션,2021년 1분기 보고서,00332927,113485612317,121613875378,-8128263061
펌텍코리아,2021년 1분기 보고서,00761059,108171953060,43239304666,64932648394
동구바이오제약,2021년 1분기 보고서,00114686,68269636153,47564735828,20704900325
동원시스템즈,2021년 1분기 보고서,00132637,197329369152,457264490765,-259935121613
케이아이엔엑스,2021년 1분기 보고서,00603348,75765443650,26987098084,48778345566
우진,2021년 1분기 보고서,00173944,42672631054,55038247192,-12365616138
파인테크닉스,2021년 1분기 보고서,00755739,49055774542,48137625102,918149440
지역난방공사,2021년 1분기 보고서,00159698,659423179601,4343419037925,-3683995858324
엠에스씨,2021년 1분기 보고서,00121154,69932046788,63780819385,6151227403
에이리츠,2021년 1분기 보고서,00860730,45621718045,23338655717,22283062328
엔피디,2021년 1분기 보고서,00876643,67232451175,42523209393,24709241782
이더블유케이,2021년 1분기 보고서,00961507,20485789436,56899637181,-36413847745
나이스디앤비,2021년 1분기 보고서,00606293,43451571074,14985036736,28466534338
우신시스템,2021년 1분기 보고서,00142883,99676915931,97012743899,2664172032
알엔투테크놀로지,2021년 1분기 보고서,00915508,46303745394,35695287445,10608457949
보라티알,2021년 1분기 보고서,01124680,55498212107,29031832520,26466379587
한국큐빅,2021년 1분기 보고서,00160010,40421793620,6143880240,34277913380
애경유화,2021년 1분기 보고서,00936787,298518479371,123330500862,175187978509
NE능률,2021년 1분기 보고서,00363927,77308088169,26318138273,50989949896
애니플러스,2021년 1분기 보고서,01335578,21383846436,14836136853,6547709583
네오셈,2021년 1분기 보고서,01170865,57948569647,37259122499,20689447148
엔젠바이오,2021년 1분기 보고서,01397903,40288654835,7985366455,32303288380
KMH하이텍,2021년 1분기 보고서,00276834,43475069129,38004588642,5470480487
푸드나무,2021년 1분기 보고서,01259311,53573744033,16072049940,37501694093
세아특수강,2021년 1분기 보고서,00133991,263840942445,137441078758,126399863687
제이엔케이히터,2021년 1분기 보고서,00442154,126421558488,87819567002,38601991486
티비에이치글로벌,2021년 1분기 보고서,00409672,67115404866,57004364491,10111040375
YW,2021년 1분기 보고서,00296263,72492840909,42476952303,30015888606
린드먼아시아,2021년 1분기 보고서,00616962,52190676086,23767123924,28423552162
이엠넷,2021년 1분기 보고서,00616290,55861859825,26027203549,29834656276
이원컴포텍,2021년 1분기 보고서,00409140,20079757501,31693561848,-11613804347
알에프텍,2021년 1분기 보고서,00309831,93102238597,57249239688,35852998909
자이에스앤디,2021년 1분기 보고서,00367844,224921490136,263434706873,-38513216737
엔케이맥스,2021년 1분기 보고서,00977650,35904746661,67294298150,-31389551489
와이즈버즈,2021년 1분기 보고서,01236532,54747837942,23822837983,30924999959
사조오양,2021년 1분기 보고서,00141875,130286789543,130940751541,-653961998
넥스트아이,2021년 1분기 보고서,00614593,56208516086,36528112464,19680403622
대웅,2021년 1분기 보고서,00111810,360001484099,29070990000,330930494099
경보제약,2021년 1분기 보고서,00101664,132931232083,94845028199,38086203884
셀트리온제약,2021년 1분기 보고서,00541349,257161732226,270144580388,-12982848162
우양,2021년 1분기 보고서,00486875,43527075903,85654560233,-42127484330
까뮤이앤씨,2021년 1분기 보고서,00129420,54300157729,86045523109,-31745365380
한샘,2021년 1분기 보고서,00161693,1083399632814,706273406692,377126226122
유틸렉스,2021년 1분기 보고서,01110678,38868185013,7899058000,30969127013
캠시스,2021년 1분기 보고서,00330044,112990984233,147478800706,-34487816473
위닉스,2021년 1분기 보고서,00293886,157751934118,150002022254,7749911864
SG세계물산,2021년 1분기 보고서,00133511,145815732854,77078926407,68736806447
가비아,2021년 1분기 보고서,00506294,21976322400,38816350424,-16840028024
파이오링크,2021년 1분기 보고서,00492353,51869261606,18211872928,33657388678
JW중외제약,2021년 1분기 보고서,00149947,327710776095,317295776037,10415000058
정산애강,2021년 1분기 보고서,00140061,60859687953,12037367445,48822320508
디에스케이,2021년 1분기 보고서,00530121,69963460239,47140803791,22822656448
대유에이피,2021년 1분기 보고서,01182578,65143440494,112663061246,-47519620752
AK홀딩스,2021년 1분기 보고서,00125080,28796557345,161844420677,-133047863332
대아티아이,2021년 1분기 보고서,00318316,98992891517,61190163961,37802727556
로체시스템즈,2021년 1분기 보고서,00363486,48688051943,47927261363,760790580
엠에프엠코리아,2021년 1분기 보고서,01384477,51284587839,38344979032,12939608807
백광산업,2021년 1분기 보고서,00122472,45934616528,140699107975,-94764491447
디스플레이텍,2021년 1분기 보고서,00371740,81669809033,33334646699,48335162334
영림원소프트랩,2021년 1분기 보고서,00532129,33873089822,19054270884,14818818938
와이지엔터테인먼트,2021년 1분기 보고서,00613318,175146499095,63866017536,111280481559
한국비엔씨,2021년 1분기 보고서,01179617,13994929162,34006093621,-20011164459
서남,2021년 1분기 보고서,00867973,7506740174,4184339554,3322400620
팅크웨어,2021년 1분기 보고서,00438036,129116825428,62883065088,66233760340
휠라홀딩스,2021년 1분기 보고서,00195229,627659287636,283014446804,344644840832
그린케미칼,2021년 1분기 보고서,00454946,86914475073,65856567062,21057908011
디씨엠,2021년 1분기 보고서,00177199,131657671545,49005111971,82652559574
일신방직,2021년 1분기 보고서,00146269,254374822313,103127622507,151247199806
우림기계,2021년 1분기 보고서,00567222,45171089666,15424330727,29746758939
대현,2021년 1분기 보고서,00113614,140971160924,46844984600,94126176324
슈피겐코리아,2021년 1분기 보고서,00917861,150936312213,40301902108,110634410105
대한과학,2021년 1분기 보고서,00608316,19586359885,8056108459,11530251426
엠씨넥스,2021년 1분기 보고서,00564562,330693794589,179189881205,151503913384
웹스,2021년 1분기 보고서,00864338,26734257783,27771666193,-1037408410
씨에스윈드,2021년 1분기 보고서,00670340,654420422058,138403132413,516017289645
윌비스,2021년 1분기 보고서,00104999,129011189531,137911460137,-8900270606
디티앤씨,2021년 1분기 보고서,00675594,24315310186,65782448181,-41467137995
메드팩토,2021년 1분기 보고서,01336373,146194504350,98811901726,47382602624
디알텍,2021년 1분기 보고서,01062867,52718823179,53652341510,-933518331
KC코트렐,2021년 1분기 보고서,00797364,160882942816,234782176124,-73899233308
엠케이전자,2021년 1분기 보고서,00121686,162046762590,217751116486,-55704353896
태경비케이,2021년 1분기 보고서,00122481,52945357837,71171999776,-18226641939
머큐리,2021년 1분기 보고서,00364740,77780557629,37905940289,39874617340
한국기업평가,2021년 1분기 보고서,00156956,56527520886,34979326257,21548194629
세하,2021년 1분기 보고서,00133706,58267573236,100203405610,-41935832374
케이디켐,2021년 1분기 보고서,00370918,58578554838,20023739382,38554815456
일진홀딩스,2021년 1분기 보고서,00146649,12995793879,27240291173,-14244497294
오킨스전자,2021년 1분기 보고서,00543107,20952895354,29865967485,-8913072131
키이스트,2021년 1분기 보고서,00353762,38840622947,24918423720,13922199227
에코캡,2021년 1분기 보고서,00870481,60186549794,46096660551,14089889243
엘컴텍,2021년 1분기 보고서,00242712,11756899629,7382232893,4374666736
디지털대성,2021년 1분기 보고서,00398808,41765389225,73208706581,-31443317356
한국콜마홀딩스,2021년 1분기 보고서,00203290,57835474401,189104483878,-131269009477
메타바이오메드,2021년 1분기 보고서,00317681,50137427341,53040380498,-2902953157
태웅로직스,2021년 1분기 보고서,00562245,121292204677,90116795113,31175409564
성보화학,2021년 1분기 보고서,00132725,92178008258,31676756581,60501251677
엘아이에스,2021년 1분기 보고서,00670085,63566191799,159287593584,-95721401785
아비코전자,2021년 1분기 보고서,00138598,81114333651,16579194473,64535139178
와이엠티,2021년 1분기 보고서,00602172,71828542808,74470770855,-2642228047
이노테라피,2021년 1분기 보고서,01110182,16571835260,2522092000,14049743260
사조씨푸드,2021년 1분기 보고서,00124780,83937953291,99883505674,-15945552383
넷마블,2021년 1분기 보고서,00904672,878431236946,1748575286576,-870144049630
코아시아옵틱스,2021년 1분기 보고서,01031502,42542248488,21558260535,20983987953
뷰노,2021년 1분기 보고서,01344202,40189621032,6997603301,33192017731
푸드웰,2021년 1분기 보고서,00165103,43463698155,27666849286,15796848869
브리지텍,2021년 1분기 보고서,00359076,21275953152,8831933204,12444019948
하츠,2021년 1분기 보고서,00221728,75712723708,18281852329,57430871379
한국카본,2021년 1분기 보고서,00159795,251181162468,96008749147,155172413321
바이넥스,2021년 1분기 보고서,00216027,102890886182,89322125779,13568760403
동방,2021년 1분기 보고서,00115287,140778583784,407807970693,-267029386909
벽산,2021년 1분기 보고서,00122898,106119013730,138835548200,-32716534470
큐로,2021년 1분기 보고서,00108746,114228515223,81091586043,33136929180
인성정보,2021년 1분기 보고서,00229021,44574385375,29671013940,14903371435
쎄미시스코,2021년 1분기 보고서,00763358,14631133782,13253157447,1377976335
신일전자,2021년 1분기 보고서,00173698,65182138147,29225412729,35956725418
GKL,2021년 1분기 보고서,00557508,295007963781,214391589481,80616374300
제룡산업,2021년 1분기 보고서,00899556,57869770417,6120943404,51748827013
성창오토텍,2021년 1분기 보고서,00486370,54906878108,47371813500,7535064608
위지윅스튜디오,2021년 1분기 보고서,01276327,11202827044,24300107547,-13097280503
나스미디어,2021년 1분기 보고서,00486097,261732191295,172731525702,89000665593
서희건설,2021년 1분기 보고서,00219848,822642744042,503681198200,318961545842
센코,2021년 1분기 보고서,01023318,23788210412,6942549912,16845660500
엘앤씨바이오,2021년 1분기 보고서,01181515,40672147988,18704381399,21967766589
원림,2021년 1분기 보고서,00143794,37653955272,27025784245,10628171027
모나미,2021년 1분기 보고서,00121288,40844800789,96507752298,-55662951509
세경하이테크,2021년 1분기 보고서,00913689,47269316112,126169941663,-78900625551
네이처셀,2021년 1분기 보고서,00117276,55365253242,25327612689,30037640553
자이글,2021년 1분기 보고서,01020524,21527353492,11122376683,10404976809
일성건설,2021년 1분기 보고서,00146232,174166277827,262164542763,-87998264936
비올,2021년 1분기 보고서,01406618,23853404793,7288543281,16564861512
일양약품,2021년 1분기 보고서,00146454,360931205336,3564134488,357367070848
팜스코,2021년 1분기 보고서,00260408,366800902748,493274729850,-126473827102
디에이피,2021년 1분기 보고서,00303192,82844592499,125075145890,-42230553391
한일사료,2021년 1분기 보고서,00162911,35456456267,24290207497,11166248770
SG,2021년 1분기 보고서,00963976,102942485629,149136411372,-46193925743
한솔케미칼,2021년 1분기 보고서,00140955,328114162696,395397382268,-67283219572
오스테오닉,2021년 1분기 보고서,01082348,41579405974,29321154391,12258251583
에코마케팅,2021년 1분기 보고서,01029394,120889320773,34347352076,86541968697
디지틀조선,2021년 1분기 보고서,00231442,50908330437,6816382749,44091947688
큐에스아이,2021년 1분기 보고서,00411446,28252343037,21836029487,6416313550
앱코,2021년 1분기 보고서,01207716,106627796596,50162268122,56465528474
명성티엔에스,2021년 1분기 보고서,01144569,32322549006,33672884254,-1350335248
유니테크노,2021년 1분기 보고서,00531865,45482820607,50079003295,-4596182688
세화피앤씨,2021년 1분기 보고서,01169267,24618768600,5933683275,18685085325
비덴트,2021년 1분기 보고서,00693651,66017504171,138060122696,-72042618525
일성신약,2021년 1분기 보고서,00146214,272764703459,26307937034,246456766425
하나머티리얼즈,2021년 1분기 보고서,00660750,110039506934,166274332275,-56234825341
포스코강판,2021년 1분기 보고서,00155258,297777984328,237513328932,60264655396
지엔코,2021년 1분기 보고서,00258102,42569323296,83454350932,-40885027636
옵티팜,2021년 1분기 보고서,00971726,25156085316,8327484014,16828601302
신세계인터내셔날,2021년 1분기 보고서,00234412,388089924072,477183748457,-89093824385
유비쿼스홀딩스,2021년 1분기 보고서,00411385,12167944976,6515230910,5652714066
흥국,2021년 1분기 보고서,00167031,42703452102,22979156330,19724295772
미창석유공업,2021년 1분기 보고서,00122056,239051138905,48892565763,190158573142
범양건영,2021년 1분기 보고서,00122694,65108112652,40435274665,24672837987
대한제분,2021년 1분기 보고서,00113243,244923230691,92496818829,152426411862
에쎈테크,2021년 1분기 보고서,00203209,29499463008,41939347567,-12439884559
덱스터,2021년 1분기 보고서,01021949,27506564385,12674068000,14832496385
덴티스,2021년 1분기 보고서,01187494,51318388946,58551108336,-7232719390
JW생명과학,2021년 1분기 보고서,00225706,52040189813,88762134064,-36721944251
에이스토리,2021년 1분기 보고서,00975290,49413204657,20558018468,28855186189
보광산업,2021년 1분기 보고서,00568461,53289716410,59501564472,-6211848062
이엔에프테크놀로지,2021년 1분기 보고서,00530185,126673001449,102877609171,23795392278
인텔리안테크,2021년 1분기 보고서,00664181,83033896069,78977233470,4056662599
원익IPS,2021년 1분기 보고서,01135941,785148224223,569208216712,215940007511
비피도,2021년 1분기 보고서,01109070,42308932587,3161656941,39147275646
대림비앤코,2021년 1분기 보고서,00109754,126971880170,172561703852,-45589823682
유니트론텍,2021년 1분기 보고서,00879020,80725479933,63210690464,17514789469
서원,2021년 1분기 보고서,00131197,80694915497,115372214895,-34677299398
천랩,2021년 1분기 보고서,01071041,36710413265,39455319190,-2744905925
씨이랩,2021년 1분기 보고서,00991298,25154610220,3246991208,21907619012
미래컴퍼니,2021년 1분기 보고서,00447760,77735695768,40240795916,37494899852
랩지노믹스,2021년 1분기 보고서,00545114,89989237105,34537432695,55451804410
티웨이항공,2021년 1분기 보고서,00671376,93957268700,613364577273,-519407308573
에이팩트,2021년 1분기 보고서,00667425,19779573035,59151867481,-39372294446
유수홀딩스,2021년 1분기 보고서,00163691,196650993052,65104530000,131546463052
쎌바이오텍,2021년 1분기 보고서,00357430,63851914464,3563272742,60288641722
에스피시스템스,2021년 1분기 보고서,00624749,25949379523,18862368182,7087011341
삼목에스폼,2021년 1분기 보고서,00125646,162212283892,53458842836,108753441056
씨티케이코스메틱스,2021년 1분기 보고서,01144028,98655532807,25195957896,73459574911
호전실업,2021년 1분기 보고서,00226316,153959892215,106835169735,47124722480
JW홀딩스,2021년 1분기 보고서,00632304,55830840832,197296149377,-141465308545
맥스로텍,2021년 1분기 보고서,00678096,6022306979,37700507831,-31678200852
옵트론텍,2021년 1분기 보고서,00327396,86528323074,140509967513,-53981644439
유바이오로직스,2021년 1분기 보고서,00927558,66294862952,58684951959,7609910993
디티알오토모티브,2021년 1분기 보고서,00116949,81151436524,43003489560,38147946964
한신기계공업,2021년 1분기 보고서,00162072,60843290278,10215595826,50627694452
아진산업,2021년 1분기 보고서,00139083,152792784686,228821885258,-76029100572
에이아이비트,2021년 1분기 보고서,00295370,21265647167,9792389489,11473257678
SNT중공업,2021년 1분기 보고서,00134477,441811187894,238930966874,202880221020
내츄럴엔도텍,2021년 1분기 보고서,00923792,51270881820,-27632155417,78903037237
SNT모티브,2021년 1분기 보고서,00398792,651118251794,365537575143,285580676651
SNT에너지,2021년 1분기 보고서,00648721,197168831493,88522321413,108646510080
보성파워텍,2021년 1분기 보고서,00267881,60524949787,30315653382,30209296405
한진,2021년 1분기 보고서,00163512,559406236914,1386949744292,-827543507378
싸이토젠,2021년 1분기 보고서,01046391,21379633030,10200279761,11179353269
진로발효,2021년 1분기 보고서,00170877,58230351931,19721585767,38508766164
모두투어리츠,2021년 1분기 보고서,01035289,5298964439,65540712160,-60241747721
동부건설,2021년 1분기 보고서,00115612,348154183826,343130954285,5023229541
이엔코퍼레이션,2021년 1분기 보고서,00389998,95345545298,8979909500,86365635798
알리코제약,2021년 1분기 보고서,00447007,64891581012,31760323495,33131257517
한신공영,2021년 1분기 보고서,00162063,975404088122,1106392036430,-130987948308
석경에이티,2021년 1분기 보고서,00921916,15717197584,5835818071,9881379513
릭스솔루션,2021년 1분기 보고서,00186452,25138072421,25587719077,-449646656
대성에너지,2021년 1분기 보고서,00787376,197273176188,376063455164,-178790278976
코오롱인더,2021년 1분기 보고서,00795135,1250077480338,1927928840244,-677851359906
현우산업,2021년 1분기 보고서,00367455,84030497302,106328235337,-22297738035
라온시큐어,2021년 1분기 보고서,00255433,25169444800,10715025116,14454419684
이노메트리,2021년 1분기 보고서,01258710,41542898316,9390006602,32152891714
제이티,2021년 1분기 보고서,00365457,42582496021,27591135168,14991360853
미투온,2021년 1분기 보고서,00965813,12281681389,35854992098,-23573310709
스튜디오드래곤,2021년 1분기 보고서,01168684,208197568558,121810343767,86387224791
서연탑메탈,2021년 1분기 보고서,00153278,78609409393,61849973816,16759435577
까스텔바작,2021년 1분기 보고서,01181807,107897715815,26236168115,81661547700
빅솔론,2021년 1분기 보고서,00478900,101841025506,17696604699,84144420807
롯데제과,2021년 1분기 보고서,01258507,506595534874,1074536092298,-567940557424
제이씨케미칼,2021년 1분기 보고서,00664853,81196421540,133527164083,-52330742543
고려시멘트,2021년 1분기 보고서,01032583,36265296349,21680289132,14585007217
슈프리마,2021년 1분기 보고서,01124653,77890569804,7727851589,70162718215
제노코,2021년 1분기 보고서,01014718,37573375849,15700635087,21872740762
라이트론,2021년 1분기 보고서,00367482,39098842346,18403208938,20695633408
우리바이오,2021년 1분기 보고서,00369107,56912541290,24635484907,32277056383
해태제과식품,2021년 1분기 보고서,00428321,141554000339,343999606917,-202445606578
비나텍,2021년 1분기 보고서,00563518,42913093076,47867664338,-4954571262
오상자이엘,2021년 1분기 보고서,00226547,35385904941,32362500373,3023404568
알티캐스트,2021년 1분기 보고서,00364254,91103027754,69739090933,21363936821
신풍제지,2021년 1분기 보고서,00137368,53292194389,3552055152,49740139237
대원미디어,2021년 1분기 보고서,00351807,28210278687,25856663088,2353615599
쇼박스,2021년 1분기 보고서,00303794,45508666178,66519636032,-21010969854
디와이파워,2021년 1분기 보고서,01059605,108585201867,51409263077,57175938790
나이벡,2021년 1분기 보고서,00767628,32009951500,21550415498,10459536002
이스트소프트,2021년 1분기 보고서,00273420,21660304281,47758580908,-26098276627
DMS,2021년 1분기 보고서,00361594,207681511133,156676650736,51004860397
아바텍,2021년 1분기 보고서,00442048,43200817360,11494648377,31706168983
사조동아원,2021년 1분기 보고서,00137252,165527373166,252144078402,-86616705236
제일약품,2021년 1분기 보고서,01236897,282047723719,243242997459,38804726260
현대건설기계,2021년 1분기 보고서,01205842,1174731083000,1146044267000,28686816000
하림,2021년 1분기 보고서,00857727,241926364806,452972602452,-211046237646
라이프시맨틱스,2021년 1분기 보고서,01336762,16929070686,6814258321,10114812365
보해양조,2021년 1분기 보고서,00123541,49999079855,65874831857,-15875752002
에스엔유,2021년 1분기 보고서,00455981,102593587578,38794024734,63799562844
후성,2021년 1분기 보고서,00595191,103618243485,178871630819,-75253387334
에이플러스에셋,2021년 1분기 보고서,00684802,74479993526,71335486098,3144507428
게임빌,2021년 1분기 보고서,00535746,199114214451,3297596000,195816618451
에스디시스템,2021년 1분기 보고서,00604815,5223769857,3352972165,1870797692
우리이앤엘,2021년 1분기 보고서,00815095,97181661511,62291738389,34889923122
듀오백,2021년 1분기 보고서,00407771,15049088001,5974543974,9074544027
대한약품,2021년 1분기 보고서,00113128,125781343466,71775832583,54005510883
효성중공업,2021년 1분기 보고서,01316245,1932475833558,46622740000,1885853093558
SIMPAC,2021년 1분기 보고서,00138260,327804217099,288847767574,38956449525
경농,2021년 1분기 보고서,00101433,151607991811,10845875000,140762116811
남선알미늄,2021년 1분기 보고서,00107224,127821009733,109008662671,18812347062
농우바이오,2021년 1분기 보고서,00176835,131192625704,48351925774,82840699930
KR모터스,2021년 1분기 보고서,00112378,82379790388,48068684000,34311106388
태웅,2021년 1분기 보고서,00186799,364491534662,348888729954,15602804708
아이에스동서,2021년 1분기 보고서,00115977,2228261629426,2194201677776,34059951650
두산,2021년 1분기 보고서,00117212,1624859841224,2564823251633,-939963410409
SGC에너지,2021년 1분기 보고서,00125150,161961073828,1083897283636,-921936209808
케이엘넷,2021년 1분기 보고서,00246620,19586781541,10249009378,9337772163
삼영전자공업,2021년 1분기 보고서,00127200,300976853757,28686928966,272289924791
씨씨에스,2021년 1분기 보고서,00249441,13753965388,6638808764,7115156624
SH에너지화학,2021년 1분기 보고서,00136457,66757935606,27013165083,39744770523
CJ ENM,2021년 1분기 보고서,00265324,989466574287,1642708301088,-653241726801
SK가스,2021년 1분기 보고서,00144164,1982420878114,2751222063684,-768801185570
한솔로지스틱스,2021년 1분기 보고서,00140946,78120002516,111654413877,-33534411361
AP위성,2021년 1분기 보고서,00874803,102024588861,33201009933,68823578928
서호전기,2021년 1분기 보고서,00220622,47586579197,34225170896,13361408301
싸이맥스,2021년 1분기 보고서,00659161,126128800568,68893020103,57235780465
펩트론,2021년 1분기 보고서,00415868,67573584114,40592266386,26981317728
세우글로벌,2021년 1분기 보고서,00134176,39349135209,1732980123,37616155086
삼양통상,2021년 1분기 보고서,00127042,327015130705,50975534305,276039596400
아이엘사이언스,2021년 1분기 보고서,01326279,15517756271,32476794689,-16959038418
하나머스트7호스팩,2021년 1분기 보고서,01513404,8421928579000,746025844000,7675902735000
모베이스,2021년 1분기 보고서,00498001,67237899024,42025934384,25211964640
우리산업,2021년 1분기 보고서,01077577,85809519630,4566081500,81243438130
인터플렉스,2021년 1분기 보고서,00369170,129261119670,159735850552,-30474730882
서린바이오,2021년 1분기 보고서,00373447,40012389439,16053540928,23958848511
뉴프렉스,2021년 1분기 보고서,00493510,52229579693,68453137721,-16223558028
예스티,2021년 1분기 보고서,00530556,34811861051,62691287277,-27879426226
앤씨앤,2021년 1분기 보고서,00537337,52973332185,50684819078,2288513107
제넥신,2021년 1분기 보고서,00545929,45435503377,57716595085,-12281091708
갤럭시아머니트리,2021년 1분기 보고서,00587457,201566805523,156386430341,45180375182
디바이스이엔지,2021년 1분기 보고서,00624509,132224672982,53815709183,78408963799
씨유메디칼,2021년 1분기 보고서,00681249,38672517635,30350178157,8322339478
야스,2021년 1분기 보고서,00875307,91431122642,33903923406,57527199236
드림시큐리티,2021년 1분기 보고서,01038693,12265384897,17146896865,-4881511968
디딤,2021년 1분기 보고서,01068658,17421011866,73731383991,-56310372125
유에스티,2021년 1분기 보고서,01196313,41880579230,11973322057,29907257173
이상네트웍스,2021년 1분기 보고서,00454399,29567438956,27101306188,2466132768
유티아이,2021년 1분기 보고서,00961774,54382855316,23103750229,31279105087
모비스,2021년 1분기 보고서,01165155,6433310285,6571237085,-137926800
오리온홀딩스,2021년 1분기 보고서,00117577,15779045017,78252117141,-62473072124
CS,2021년 1분기 보고서,00303703,20483255438,4762905025,15720350413
삼진엘앤디,2021년 1분기 보고서,00239514,67017552976,53269125633,13748427343
더존비즈온,2021년 1분기 보고서,00172291,126844080085,416303003910,-289458923825
유니온커뮤니티,2021년 1분기 보고서,00408266,40961763323,23658312297,17303451026
에스에프에이,2021년 1분기 보고서,00358271,690603234089,252711551446,437891682643
에스퓨얼셀,2021년 1분기 보고서,01257872,113166358729,8409146684,104757212045
솔브레인,2021년 1분기 보고서,01489648,326799478284,3889283000,322910195284
베뉴지,2021년 1분기 보고서,00267906,112476887494,164080118990,-51603231496
조비,2021년 1분기 보고서,00148948,56345684461,54013256163,2332428298
두산중공업,2021년 1분기 보고서,00159616,3547637737353,8199365903945,-4651728166592
광진윈텍,2021년 1분기 보고서,00365624,41360442594,53203713770,-11843271176
미래테크놀로지,2021년 1분기 보고서,01015726,22090006468,1995035889,20094970579
윈텍,2021년 1분기 보고서,01359815,18730461218,5009268457,13721192761
유니테스트,2021년 1분기 보고서,00540447,89091712367,18951552603,70140159764
지엠비코리아,2021년 1분기 보고서,00156354,197594518970,224443707759,-26849188789
아이티엠반도체,2021년 1분기 보고서,00579980,244566627412,139735399665,104831227747
제노포커스,2021년 1분기 보고서,00983916,27384752216,38926849975,-11542097759
하나기술,2021년 1분기 보고서,00601191,61838153813,62856668671,-1018514858
지누스,2021년 1분기 보고서,00150633,287692462572,164380977017,123311485555
링네트,2021년 1분기 보고서,00352499,97303049884,52368086783,44934963101
나노씨엠에스,2021년 1분기 보고서,00660459,27618267281,6775514099,20842753182
신성델타테크,2021년 1분기 보고서,00136226,39012399927,88926675776,-49914275849
경창산업,2021년 1분기 보고서,00102353,121870420521,364444327851,-242573907330
이엘피,2021년 1분기 보고서,00374020,46089758388,6918979100,39170779288
아이디스,2021년 1분기 보고서,00883980,132651414804,32785724573,99865690231
켐트로스,2021년 1분기 보고서,01089350,26157877224,26534533112,-376655888
아이디피,2021년 1분기 보고서,01213586,32500938458,2588817199,29912121259
세종텔레콤,2021년 1분기 보고서,00268002,261705289904,104237571442,157467718462
오하임아이엔티,2021년 1분기 보고서,01335453,26368724100,8192410237,18176313863
황금에스티,2021년 1분기 보고서,00218575,107530524194,54983718572,52546805622
모헨즈,2021년 1분기 보고서,00163318,5903954240,7075827532,-1171873292
KNN,2021년 1분기 보고서,00208134,49971990217,11358842317,38613147900
유진로봇,2021년 1분기 보고서,00234227,32105405031,16444005729,15661399302
아이에이치큐,2021년 1분기 보고서,00154426,45563045485,73117874000,-27554828515
에이블씨엔씨,2021년 1분기 보고서,00400857,104815268457,80262788584,24552479873
녹십자랩셀,2021년 1분기 보고서,01010642,33499054991,40374823834,-6875768843
유진테크,2021년 1분기 보고서,00531014,188261683220,54424105760,133837577460
브랜드엑스코퍼레이션,2021년 1분기 보고서,01391103,18727586146,9531484000,9196102146
픽셀플러스,2021년 1분기 보고서,00495086,46516015530,7983420061,38532595469
아이스크림에듀,2021년 1분기 보고서,00983934,54111494271,27432786406,26678707865
아스타,2021년 1분기 보고서,01157235,4275456978,1839436770,2436020208
엘앤에프,2021년 1분기 보고서,00398701,325169658310,393433544523,-68263886213
삼성에스디에스,2021년 1분기 보고서,00126186,4194060813091,1261471580070,2932589233021
신도리코,2021년 1분기 보고서,00135795,679239733865,53308419996,625931313869
멀티캠퍼스,2021년 1분기 보고서,00425351,51801451704,111105187867,-59303736163
한국주철관공업,2021년 1분기 보고서,00159573,108720366190,37649519163,71070847027
팍스넷,2021년 1분기 보고서,00334624,10794938991,38874352927,-28079413936
바이오다인,2021년 1분기 보고서,01117413,35284834757,12323742139,22961092618
대양전기공업,2021년 1분기 보고서,00111193,126977267373,41718564837,85258702536
서울제약,2021년 1분기 보고서,00131018,24782515875,37416054978,-12633539103
계양전기,2021년 1분기 보고서,00102618,280386821519,137332649370,143054172149
남광토건,2021년 1분기 보고서,00107066,172714321095,179220190548,-6505869453
한국선재,2021년 1분기 보고서,00158015,67387526509,81932015849,-14544489340
대영포장,2021년 1분기 보고서,00111458,67294802514,56514661583,10780140931
메디프론,2021년 1분기 보고서,00391197,29027324650,11210951294,17816373356
녹원씨엔아이,2021년 1분기 보고서,00393469,23762351299,49886590724,-26124239425
KTcs,2021년 1분기 보고서,00372882,185281478227,134863078212,50418400015
제이앤티씨,2021년 1분기 보고서,00447575,127497849208,67557808536,59940040672
덴티움,2021년 1분기 보고서,00526599,167370580842,274638497860,-107267917018
인포뱅크,2021년 1분기 보고서,00243757,25659964905,17166150553,8493814352
콜마비앤에이치,2021년 1분기 보고서,01032404,229513909449,104497713099,125016196350
동원개발,2021년 1분기 보고서,00117966,1051738241540,164573973596,887164267944
에이프로,2021년 1분기 보고서,00604268,60483409808,25256121950,35227287858
네오오토,2021년 1분기 보고서,00876865,48260020984,57944181876,-9684160892
호텔신라,2021년 1분기 보고서,00165680,1504365533111,200000000000,1304365533111
플레이디,2021년 1분기 보고서,00862853,99482509540,49739731371,49742778169
삼호개발,2021년 1분기 보고서,00128980,177748735046,96579179162,81169555884
진양산업,2021년 1분기 보고서,00150439,18822340342,20448238910,-1625898568
파라다이스,2021년 1분기 보고서,00171265,424955111582,736434820112,-311479708530
대원강업,2021년 1분기 보고서,00111847,161324034591,256152428399,-94828393808
한국팩키지,2021년 1분기 보고서,00198192,28278330824,33959354249,-5681023425
해성산업,2021년 1분기 보고서,00219361,20601745077,220394776109,-199793031032
세아제강지주,2021년 1분기 보고서,00124197,25572982834,46145833982,-20572851148
한국경제TV,2021년 1분기 보고서,00263371,82355689720,11500000000,70855689720
엑사이엔씨,2021년 1분기 보고서,00360577,37263842777,51545056397,-14281213620
삼진제약,2021년 1분기 보고서,00128412,150702033947,74127326837,76574707110
탑엔지니어링,2021년 1분기 보고서,00366845,121855589721,96240970218,25614619503
삼화페인트공업,2021년 1분기 보고서,00129387,246810094817,255304815606,-8494720789
KG모빌리언스,2021년 1분기 보고서,00405278,295604961006,156303835527,139301125479
신대양제지,2021년 1분기 보고서,00135777,107139565844,41517537439,65622028405
누리플랜,2021년 1분기 보고서,00410997,13496016026,25466493190,-11970477164
신라교역,2021년 1분기 보고서,00135962,190571635444,87223886912,103347748532
오뚜기,2021년 1분기 보고서,00141529,767568792743,808226694712,-40657901969
플랜티넷,2021년 1분기 보고서,00490179,11764688308,5488078275,6276610033
일동홀딩스,2021년 1분기 보고서,00146083,4951134001,78122809937,-73171675936
에이테크솔루션,2021년 1분기 보고서,00384887,91403169893,88944490973,2458678920
셀리버리,2021년 1분기 보고서,01182444,52840920512,24247585446,28593335066
우주일렉트로,2021년 1분기 보고서,00390903,122085370017,4967110000,117118260017
룽투코리아,2021년 1분기 보고서,00373571,54033422798,5155826143,48877596655
락앤락,2021년 1분기 보고서,00561866,106617468767,76332784143,30284684624
이라이콤,2021년 1분기 보고서,00137289,158522982530,37528943998,120994038532
대보마그네틱,2021년 1분기 보고서,01259418,40406556811,17369263874,23037292937
한미글로벌,2021년 1분기 보고서,00413523,74108081829,48950663409,25157418420
동아지질,2021년 1분기 보고서,00178754,245253965774,141521643647,103732322127
센트랄모텍,2021년 1분기 보고서,00450010,75185526094,150168297895,-74982771801
이루다,2021년 1분기 보고서,01142400,31926374809,15416890818,16509483991
코아스템,2021년 1분기 보고서,00989664,54714302077,45590650265,9123651812
종근당홀딩스,2021년 1분기 보고서,00149354,52620789931,46905006790,5715783141
청담러닝,2021년 1분기 보고서,00525882,69247560086,17037019706,52210540380
진흥기업,2021년 1분기 보고서,00150828,168907449984,160918755466,7988694518
로보스타,2021년 1분기 보고서,00536523,93997473979,51738853950,42258620029
태광산업,2021년 1분기 보고서,00153393,1610699909746,577111787735,1033588122011
장원테크,2021년 1분기 보고서,00659684,26846883319,69430695563,-42583812244
풍산홀딩스,2021년 1분기 보고서,00155531,76975122645,55819810803,21155311842
코스메카코리아,2021년 1분기 보고서,00763473,75069452812,120240886262,-45171433450
한국프랜지공업,2021년 1분기 보고서,00160418,273321417239,255817160700,17504256539
나무가,2021년 1분기 보고서,00819374,148074817388,129180440461,18894376927
퍼시스,2021년 1분기 보고서,00161709,276947219709,67150100298,209797119411
에이치엔티,2021년 1분기 보고서,00872452,5804162491,4207630931,1596531560
한올바이오파마,2021년 1분기 보고서,00162586,131129950202,39996076025,91133874177
필옵틱스,2021년 1분기 보고서,00938721,68632040858,95008501460,-26376460602
오션브릿지,2021년 1분기 보고서,01113754,40464859225,11399659921,29065199304
코스맥스비티아이,2021년 1분기 보고서,00219574,58123560405,169122641791,-110999081386
잉글우드랩,2021년 1분기 보고서,01165739,52899168,26576619,26322549
CJ대한통운,2021년 1분기 보고서,00113410,1302738704544,4063032296786,-2760293592242
비츠로테크,2021년 1분기 보고서,00103644,12245254068,20599173048,-8353918980
명문제약,2021년 1분기 보고서,00121039,80264217434,105219332382,-24955114948
CJ프레시웨이,2021년 1분기 보고서,00127954,344193357786,848750122153,-504556764367
에쓰씨엔지니어링,2021년 1분기 보고서,00121969,9524961716,30907739634,-21382777918
서한,2021년 1분기 보고서,00131504,443340647380,240565655471,202774991909
에코플라스틱,2021년 1분기 보고서,00139153,142686887856,261812816724,-119125928868
코오롱,2021년 1분기 보고서,00152862,51705910079,666276754837,-614570844758
한탑,2021년 1분기 보고서,00140566,30970169755,78619938578,-47649768823
이화전기,2021년 1분기 보고서,00145738,97993946574,55331576067,42662370507
국동,2021년 1분기 보고서,00168331,91931078380,65119821867,26811256513
피제이전자,2021년 1분기 보고서,00155735,68783270659,40424555222,28358715437
CJ CGV,2021년 1분기 보고서,00303873,539409703372,2061392284346,-1521982580974
시그네틱스,2021년 1분기 보고서,00158219,84916624214,47115834713,37800789501
교촌에프앤비,2021년 1분기 보고서,00453284,55746962931,62283188927,-6536225996
동국산업,2021년 1분기 보고서,00172680,181693812561,116540959708,65152852853
진도,2021년 1분기 보고서,00557933,72378574130,27697684096,44680890034
리더스코스메틱,2021년 1분기 보고서,00180263,20979820816,39753785300,-18773964484
미원홀딩스,2021년 1분기 보고서,00706715,10147206041,60682982169,-50535776128
일동제약,2021년 1분기 보고서,01168383,307249660232,447532009742,-140282349510
신일제약,2021년 1분기 보고서,00137058,53114435456,17747332315,35367103141
한창제지,2021년 1분기 보고서,00163761,115880354655,112594600848,3285753807
대화제약,2021년 1분기 보고서,00210740,119512799688,9284689500,110228110188
명신산업,2021년 1분기 보고서,00173078,116307806902,124269287459,-7961480557
제일제강,2021년 1분기 보고서,00148531,37111413283,39149538751,-2038125468
도화엔지니어링,2021년 1분기 보고서,00114552,182141516763,178414087562,3727429201
KG동부제철,2021년 1분기 보고서,00115676,660289719478,1325695229842,-665405510364
이엠텍,2021년 1분기 보고서,00541163,134772131506,68834907750,65937223756
삼성중공업,2021년 1분기 보고서,00126478,5737663674737,8526689649307,-2789025974570
셀리드,2021년 1분기 보고서,01235296,26988234834,14543400000,12444834834
소프트캠프,2021년 1분기 보고서,01182408,9460907942,4122967892,5337940050
옵티시스,2021년 1분기 보고서,00660291,33428657756,4120144178,29308513578
이엔드디,2021년 1분기 보고서,00619640,77146425452,48989941893,28156483559
가온미디어,2021년 1분기 보고서,00441304,200376986942,130648841960,69728144982
에스앤에스텍,2021년 1분기 보고서,00411048,83873268648,26981642653,56891625995
트루윈,2021년 1분기 보고서,00766106,40545316377,50213764522,-9668448145
효성,2021년 1분기 보고서,00117188,531127356970,536467595008,-5340238038
풀무원,2021년 1분기 보고서,00155355,139019495407,149725503900,-10706008493
삼일제약,2021년 1분기 보고서,00128032,64740183617,130973270444,-66233086827
유한양행,2021년 1분기 보고서,00145109,2251733004254,1612335490870,639397513384
삼성물산,2021년 1분기 보고서,00149655,8175008230927,16885876222172,-8710867991245
LG유플러스,2021년 1분기 보고서,00231363,4774876000000,9786325000000,-5011449000000
대한유화,2021년 1분기 보고서,00260383,783597533755,260489900378,523107633377
만도,2021년 1분기 보고서,01042775,3353520710331,365027354249,2988493356082
우진아이엔에스,2021년 1분기 보고서,00143262,75250401090,20495463822,54754937268
한국공항,2021년 1분기 보고서,00156691,190994495926,146154753322,44839742604
씨엠에스에듀,2021년 1분기 보고서,00914040,84892166159,9476384000,75415782159
에이에프더블류,2021년 1분기 보고서,01223219,49094175601,10128444000,38965731601
삼원강재,2021년 1분기 보고서,00191588,134565034349,48110234857,86454799492
DL,2021년 1분기 보고서,00109693,732488712233,826781824441,-94293112208
현대오토에버,2021년 1분기 보고서,00362441,765877757799,484561938677,281315819122
LF,2021년 1분기 보고서,00593032,730941088848,459217121088,271723967760
CJ제일제당,2021년 1분기 보고서,00635134,1434947905000,4566196696000,-3131248791000
패션플랫폼,2021년 1분기 보고서,01101041,29451502076,12669329701,16782172375
한송네오텍,2021년 1분기 보고서,01101722,33672365815,22362515333,11309850482
비즈니스온,2021년 1분기 보고서,01014657,21832930811,7275596781,14557334030
삼아알미늄,2021년 1분기 보고서,00126779,88444931133,106182834789,-17737903656
흥구석유,2021년 1분기 보고서,00167004,28425659550,6682027626,21743631924
성우전자,2021년 1분기 보고서,00364306,41656079110,4110717800,37545361310
잇츠한불,2021년 1분기 보고서,00911955,236860251209,9008346528,227851904681
코스맥스,2021년 1분기 보고서,01009789,346683113228,532080322045,-185397208817
서연이화,2021년 1분기 보고서,01036446,411661691891,530046586387,-118384894496
마크로젠,2021년 1분기 보고서,00261373,81628272640,71404611159,10223661481
동일산업,2021년 1분기 보고서,00172936,241108106267,47595350490,193512755777
휴젤,2021년 1분기 보고서,00888347,542806275806,182839813576,359966462230
동양파일,2021년 1분기 보고서,00993931,69063118588,9993501263,59069617325
경동나비엔,2021년 1분기 보고서,00101488,284728904147,261787669388,22941234759
삼양식품,2021년 1분기 보고서,00126955,177205362095,211873294706,-34667932611
THE E&M,2021년 1분기 보고서,00519252,56064975633,23904016420,32160959213
삼일씨엔에스,2021년 1분기 보고서,00109806,130866031057,50411953137,80454077920
휴맥스,2021년 1분기 보고서,00787057,441440374110,582106435386,-140666061276
테이팩스,2021년 1분기 보고서,00256955,67684621060,45517305043,22167316017
아세아시멘트,2021년 1분기 보고서,00990165,122292268812,352999513032,-230707244220
감성코퍼레이션,2021년 1분기 보고서,00261009,21903609413,9007625643,12895983770
폴라리스오피스,2021년 1분기 보고서,00269852,25556097016,18731580000,6824517016
레몬,2021년 1분기 보고서,01011395,25164228310,17502354463,7661873847
네오리진,2021년 1분기 보고서,00599106,8140501397,3991144062,4149357335
연이비앤티,2021년 1분기 보고서,00495554,37082156483,40490945138,-3408788655
피앤씨테크,2021년 1분기 보고서,00525864,41283181162,7551730126,33731451036
롯데쇼핑,2021년 1분기 보고서,00120526,3923725936493,16231611238178,-12307885301685
뷰웍스,2021년 1분기 보고서,00609324,129582091158,43769466442,85812624716
센트럴인사이트,2021년 1분기 보고서,00151863,16576490933,7973775464,8602715469
SK,2021년 1분기 보고서,00181712,2145506000000,9528271000000,-7382765000000
쿠콘,2021년 1분기 보고서,01311055,77953553426,79859738820,-1906185394
용평리조트,2021년 1분기 보고서,00365989,181887770659,550050789020,-368163018361
에스케이바이오팜,2021년 1분기 보고서,00878696,535845042891,116872434961,418972607930
에스아이리소스,2021년 1분기 보고서,00120906,8826654290,2295007057,6531647233
동원F&B,2021년 1분기 보고서,00340917,503472439200,651075439001,-147602999801
이노와이즈,2021년 1분기 보고서,00166333,11529101895,28351183944,-16822082049
광전자,2021년 1분기 보고서,00152729,119053675025,39007694993,80045980032
신라젠,2021년 1분기 보고서,00919966,19191348347,24743078717,-5551730370
KH 일렉트론,2021년 1분기 보고서,00125965,36714952113,59670279278,-22955327165
이즈미디어,2021년 1분기 보고서,00861720,36951705450,35158358867,1793346583
바이오로그디바이스,2021년 1분기 보고서,01047707,32614019724,46219686353,-13605666629
시스웍,2021년 1분기 보고서,01188378,32329773258,37980329500,-5650556242
세틀뱅크,2021년 1분기 보고서,00763701,166043462492,86654372257,79389090235
케어젠,2021년 1분기 보고서,00549891,147069734086,25755122903,121314611183
수산중공업,2021년 1분기 보고서,00135111,44305166582,57828409431,-13523242849
삼보산업,2021년 1분기 보고서,00125822,94867646541,194305231262,-99437584721
에코마이스터,2021년 1분기 보고서,00127699,6780812721,44904754911,-38123942190
일진머티리얼즈,2021년 1분기 보고서,00113997,301229000000,102927000000,198302000000
모베이스전자,2021년 1분기 보고서,00137234,260673688518,416524559263,-155850870745
한국알콜,2021년 1분기 보고서,00158565,172422815456,55389604727,117033210729
코너스톤네트웍스,2021년 1분기 보고서,00194275,25564842075,27300256316,-1735414241
아시아나항공,2021년 1분기 보고서,00138792,1798365672232,11980075631198,-10181709958966
경동인베스트,2021년 1분기 보고서,00143527,37467549077,2368498916,35099050161
UCI,2021년 1분기 보고서,00215976,7303255195,24467990079,-17164734884
제일연마,2021년 1분기 보고서,00148461,41786482965,12521906099,29264576866
티씨케이,2021년 1분기 보고서,00245472,209986952359,45002268885,164984683474
COWON,2021년 1분기 보고서,00361266,19007240928,4491197489,14516043439
한국내화,2021년 1분기 보고서,00160205,74266451213,65914429574,8352021639
새론오토모티브,2021년 1분기 보고서,00305668,91032381355,26228343492,64804037863
신세계I&C,2021년 1분기 보고서,00219486,132812995171,56653915648,76159079523
넥스턴바이오,2021년 1분기 보고서,00416414,70592074296,3226410918,67365663378
강남제비스코,2021년 1분기 보고서,00100939,142885489000,85885567011,56999921989
아센디오,2021년 1분기 보고서,00145437,18069102249,8560313063,9508789186
코윈테크,2021년 1분기 보고서,01211232,75879606964,43623431017,32256175947
깨끗한나라,2021년 1분기 보고서,00113492,137190573795,364642496181,-227451922386
SK디스커버리,2021년 1분기 보고서,00131832,250545589454,236485784312,14059805142
SBS콘텐츠허브,2021년 1분기 보고서,00280688,144741757518,39695899858,105045857660
가온전선,2021년 1분기 보고서,00104768,344510667688,325097275950,19413391738
남해화학,2021년 1분기 보고서,00107987,414400928960,166987168252,247413760708
싸이버원,2021년 1분기 보고서,01293953,22766890901,4949927465,17816963436
프레스티지바이오로직스,2021년 1분기 보고서,01258428,96005893617,40430206666,55575686951
이크레더블,2021년 1분기 보고서,00634728,56804477984,20391825572,36412652412
대유플러스,2021년 1분기 보고서,00126089,82617767846,133395401148,-50777633302
팬젠,2021년 1분기 보고서,00962922,22559730488,22282415038,277315450
아시아나IDT,2021년 1분기 보고서,00458234,132440380420,69771614218,62668766202
컴투스,2021년 1분기 보고서,00476498,672279503201,128473265419,543806237782
KEC,2021년 1분기 보고서,00589127,211466277509,233765119604,-22298842095
서울바이오시스,2021년 1분기 보고서,00488402,123595077684,247306784985,-123711707301
에어부산,2021년 1분기 보고서,00651901,76780304460,939387470812,-862607166352
제이스텍,2021년 1분기 보고서,00493185,50591110397,31242702786,19348407611
에스와이,2021년 1분기 보고서,00535481,128331404465,121637858646,6693545819
모바일리더,2021년 1분기 보고서,00641171,12820391441,13154002180,-333610739
엔시트론,2021년 1분기 보고서,00641393,34571770144,24922133282,9649636862
스킨앤스킨,2021년 1분기 보고서,00896753,24690324772,7021630260,17668694512
나무기술,2021년 1분기 보고서,01136348,30916906706,23076783964,7840122742
NHN벅스,2021년 1분기 보고서,00645089,36100823636,20565372686,15535450950
젠큐릭스,2021년 1분기 보고서,01051472,8092117311,7746783967,345333344
샘코,2021년 1분기 보고서,00971090,16593667452,32476346469,-15882679017
포스코,2021년 1분기 보고서,00155319,20397788524951,12585022466455,7812766058496
화승코퍼레이션,2021년 1분기 보고서,00166272,300008658948,25025626000,274983032948
웅진씽크빅,2021년 1분기 보고서,00628189,417163962678,267599552061,149564410617
포스코엠텍,2021년 1분기 보고서,00128111,113502334895,39326990033,74175344862
동화약품,2021년 1분기 보고서,00119195,209356906420,80204758240,129152148180
네오이뮨텍,2021년 1분기 보고서,01511558,166079691,14187645,151892046
TS트릴리온,2021년 1분기 보고서,01353024,12633889793,12520970141,112919652
에이스침대,2021년 1분기 보고서,00140052,104386213064,86581469196,17804743868
나인테크,2021년 1분기 보고서,01208849,59918325566,59598609021,319716545
베스파,2021년 1분기 보고서,01259056,31495545278,23242746952,8252798326
대성홀딩스,2021년 1분기 보고서,00108940,42414952313,130192395745,-87777443432
유일에너테크,2021년 1분기 보고서,01368637,52744026540,17683166647,35060859893
대한항공,2021년 1분기 보고서,00113526,5125097125097,19550448229118,-14425351104021
퓨쳐켐,2021년 1분기 보고서,01053540,41113856159,3527457796,37586398363
현대무벡스,2021년 1분기 보고서,01358463,176022209675,51747917984,124274291691
케이씨티시,2021년 1분기 보고서,00103042,84872146215,194085570923,-109213424708
프리시젼바이오,2021년 1분기 보고서,01137295,21787568950,4491218460,17296350490
전방,2021년 1분기 보고서,00147222,225801770150,235429229235,-9627459085
세원이앤씨,2021년 1분기 보고서,00585219,93105894456,146123901262,-53018006806
광주신세계,2021년 1분기 보고서,00220561,162088908225,97451861691,64637046534
엔에프씨,2021년 1분기 보고서,01217829,32993779211,27231822326,5761956885
LIG넥스원,2021년 1분기 보고서,00503668,1539610518978,1917530743580,-377920224602
SK머티리얼즈,2021년 1분기 보고서,00110051,190770559524,851962504225,-661191944701
와이더플래닛,2021년 1분기 보고서,01116502,17439343915,6214547716,11224796199
자안코스메틱,2021년 1분기 보고서,01089378,24228507057,8237597419,15990909638
지티지웰니스,2021년 1분기 보고서,01031229,28365160727,42055886545,-13690725818
현대에너지솔루션,2021년 1분기 보고서,01199550,362341615259,188364649753,173976965506
드림텍,2021년 1분기 보고서,00415646,99592059537,98600285403,991774134
동일제강,2021년 1분기 보고서,00118451,84967679406,22949871304,62017808102
율촌화학,2021년 1분기 보고서,00145260,205588437565,265215170941,-59626733376
SG글로벌,2021년 1분기 보고서,00152039,46827504516,60536221411,-13708716895
블루베리 NFT,2021년 1분기 보고서,00173449,15944233493,18870720271,-2926486778
동성케미컬,2021년 1분기 보고서,00679314,83808845719,136165321127,-52356475408
케이엠더블유,2021년 1분기 보고서,00226352,205711954532,98907800783,106804153749
삼표시멘트,2021년 1분기 보고서,00239639,180122774738,539647487967,-359524713229
투비소프트,2021년 1분기 보고서,00596260,19913158767,14515268073,5397890694
폴라리스웍스,2021년 1분기 보고서,00615723,20440637555,19302190154,1138447401
원익피앤이,2021년 1분기 보고서,00785475,124308885164,66333853951,57975031213
대창단조,2021년 1분기 보고서,00112679,125002848975,26532292266,98470556709
원익큐브,2021년 1분기 보고서,00128175,107044496645,55375128659,51669367986
골드앤에스,2021년 1분기 보고서,00249502,12826270527,10340154365,2486116162
현대이지웰,2021년 1분기 보고서,00656951,129637156472,79739209374,49897947098
KH E&T,2021년 1분기 보고서,01097906,150350754714,-10735620204,161086374918
계룡건설산업,2021년 1분기 보고서,00102432,1086449161681,1178150092009,-91700930328
피엔케이피부임상연구센타,2021년 1분기 보고서,01290381,44049301602,4034219269,40015082333
광림,2021년 1분기 보고서,00103635,59133664553,91425675588,-32292011035
사조산업,2021년 1분기 보고서,00124799,188675592668,251548897613,-62873304945
현대사료,2021년 1분기 보고서,00164618,73929148536,37855343147,36073805389
코맥스,2021년 1분기 보고서,00268118,69726430612,40699150272,29027280340
MP그룹,2021년 1분기 보고서,00390860,45509666923,19153668178,26355998745
바이브컴퍼니,2021년 1분기 보고서,00403793,17526858528,20781493507,-3254634979
하이로닉,2021년 1분기 보고서,00977641,27885213820,3179555622,24705658198
수젠텍,2021년 1분기 보고서,01063954,22596506632,7647483000,14949023632
센트럴바이오,2021년 1분기 보고서,00347716,48924817001,29539320204,19385496797
쌍용씨앤이,2021년 1분기 보고서,00138224,614949297333,1306075186572,-691125889239
현대코퍼레이션,2021년 1분기 보고서,00164812,623066253693,657158606849,-34092353156
삼성SDI,2021년 1분기 보고서,00126362,3717566650244,4394642030844,-677075380600
이노인스트루먼트,2021년 1분기 보고서,01065679,12498979862,3779659716,8719320146
한국테크놀로지,2021년 1분기 보고서,00355548,21610680083,30068605921,-8457925838
파세코,2021년 1분기 보고서,00238153,55911129892,37463680813,18447449079
오리엔트정공,2021년 1분기 보고서,00300405,15015492650,36277397554,-21261904904
동서,2021년 1분기 보고서,00144395,730135194493,122103923635,608031270858
한일홀딩스,2021년 1분기 보고서,00162993,367789656427,500260250822,-132470594395
코데즈컴바인,2021년 1분기 보고서,00329093,18572617910,6009150332,12563467578
형지I&C,2021년 1분기 보고서,00142713,34723950972,34118828744,605122228
현대에버다임,2021년 1분기 보고서,00228536,160650398783,61498982825,99151415958
자안바이오,2021년 1분기 보고서,00493431,21442140385,75115450440,-53673310055
DRB동일,2021년 1분기 보고서,00118266,100863517906,100855956408,7561498
KTis,2021년 1분기 보고서,00372873,176711053430,123171496884,53539556546
일신석재,2021년 1분기 보고서,00146296,41444558038,40782114350,662443688
디엔에프,2021년 1분기 보고서,00569691,42274475576,12395448788,29879026788
TYM,2021년 1분기 보고서,00117230,252709517047,271918377638,-19208860591
피에이치에이,2021년 1분기 보고서,00155151,300201728500,208865606416,91336122084
수성이노베이션,2021년 1분기 보고서,00243979,36779080908,11254934500,25524146408
SUN&L,2021년 1분기 보고서,00132211,121291967431,214982894986,-93690927555
DL이앤씨,2021년 1분기 보고서,01524093,3626126844607,3038201820440,587925024167
미코바이오메드,2021년 1분기 보고서,01049167,57695078170,13573801834,44121276336
자이언트스텝,2021년 1분기 보고서,01264438,26463369643,6572772985,19890596658
에이치엘비,2021년 1분기 보고서,00199252,170393966351,35989963772,134404002579
비디아이,2021년 1분기 보고서,00610490,131451066799,177827232689,-46376165890
DL건설,2021년 1분기 보고서,00128971,1168928582274,741496354658,427432227616
초록뱀미디어,2021년 1분기 보고서,00299464,73065560549,145778549152,-72712988603
알체라,2021년 1분기 보고서,01405451,23859099958,2978625893,20880474065
LG생활건강,2021년 1분기 보고서,00356370,1103049622047,978093749351,124955872696
클리노믹스,2021년 1분기 보고서,01201970,27295750940,2827172325,24468578615
기아,2021년 1분기 보고서,00106641,25968796000000,20182876000000,5785920000000
대호특수강,2021년 1분기 보고서,00166175,88484591267,85190336300,3294254967
동원수산,2021년 1분기 보고서,00118044,48059456292,44247568174,3811888118
한양이엔지,2021년 1분기 보고서,00216762,245167422062,145381899711,99785522351
유양디앤유,2021년 1분기 보고서,00144720,80331578411,22189083666,58142494745
현대에이치티,2021년 1분기 보고서,00255044,60827657434,22366917088,38460740346
초록뱀컴퍼니,2021년 1분기 보고서,00349811,31828880404,44621722211,-12792841807
하이브,2021년 1분기 보고서,01204056,945450991000,511204586000,434246405000
현대중공업지주,2021년 1분기 보고서,01205709,536382013000,2450937061000,-1914555048000
RF머트리얼즈,2021년 1분기 보고서,01343665,19451182697,11703868475,7747314222
청보산업,2021년 1분기 보고서,00151605,44697096141,56027564124,-11330467983
금호건설,2021년 1분기 보고서,00106313,1518166909694,233077292657,1285089617037
LS전선아시아,2021년 1분기 보고서,01093007,30874810734,18874092983,12000717751
코디,2021년 1분기 보고서,00308559,68191744631,-36755558601,104947303232
일정실업,2021년 1분기 보고서,00146542,51410150228,21990454012,29419696216
롯데정밀화학,2021년 1분기 보고서,00157681,558637056047,229193609644,329443446403
진양홀딩스,2021년 1분기 보고서,00646732,57592081824,32724864112,24867217712
삼화전기,2021년 1분기 보고서,00129271,46869985623,68000513987,-21130528364
에이프로젠 KIC,2021년 1분기 보고서,00152385,182467425815,277968429723,-95501003908
쌍용자동차,2021년 1분기 보고서,00138242,1935199420910,-997799815527,2932999236437
티엘비,2021년 1분기 보고서,00920379,64830926511,41107154522,23723771989
대동,2021년 1분기 보고서,00109286,415502696576,510797806794,-95295110218
KH 필룩스,2021년 1분기 보고서,00193009,127674321465,32859225559,94815095906
고려아연,2021년 1분기 보고서,00102858,3652461783407,803384745059,2849077038348
대한광통신,2021년 1분기 보고서,00113261,136326604890,118365809229,17960795661
와이지-원,2021년 1분기 보고서,00139719,301700411512,462752007584,-161051596072
현대위아,2021년 1분기 보고서,00106623,3007943000000,2839549000000,168394000000
한일현대시멘트,2021년 1분기 보고서,00164672,188744763753,314282761241,-125537997488
한컴MDS,2021년 1분기 보고서,00445841,55798257468,17527136424,38271121044
한솔인티큐브,2021년 1분기 보고서,00470829,28793839831,11039849099,17753990732
현대모비스,2021년 1분기 보고서,00164788,15771196000000,7663778000000,8107418000000
모다이노칩,2021년 1분기 보고서,00480048,83828421262,416616229085,-332787807823
알파홀딩스,2021년 1분기 보고서,00605124,47129177376,61171442204,-14042264828
SK렌터카,2021년 1분기 보고서,00201450,271182992561,1939992582993,-1668809590432
녹십자웰빙,2021년 1분기 보고서,01135057,56076919296,40425372002,15651547294
SNT홀딩스,2021년 1분기 보고서,00225159,20288719607,730427002,19558292605
월덱스,2021년 1분기 보고서,00580065,68799953359,75371355852,-6571402493
에스원,2021년 1분기 보고서,00158501,761454281937,544941428495,216512853442
스맥,2021년 1분기 보고서,00580056,112488601006,112206367398,282233608
GS글로벌,2021년 1분기 보고서,00138190,466654970430,427756321331,38898649099
누리플렉스,2021년 1분기 보고서,00269889,38784411786,39967345729,-1182933943
지유온,2021년 1분기 보고서,00689418,18114832751,13048383245,5066449506
솔루스첨단소재,2021년 1분기 보고서,01412822,113929556303,120570293923,-6640737620
비케이탑스,2021년 1분기 보고서,00273615,55830572313,91744317457,-35913745144
동아에스티,2021년 1분기 보고서,00956930,466296336778,355503996496,110792340282
엘에스일렉트릭,2021년 1분기 보고서,00105855,1251007922643,983444895202,267563027441
국일제지,2021년 1분기 보고서,00104573,44808781117,62947935181,-18139154064
대성엘텍,2021년 1분기 보고서,00110583,50435561877,70417607838,-19982045961
신신제약,2021년 1분기 보고서,00136448,41043513177,63759702530,-22716189353
국일신동,2021년 1분기 보고서,00203847,19176002273,5195760977,13980241296
디피씨,2021년 1분기 보고서,00117498,48190846848,17903431248,30287415600
세기상사,2021년 1분기 보고서,00133618,982700512,19775751856,-18793051344
희림,2021년 1분기 보고서,00236863,120161519030,107865040601,12296478429
에넥스,2021년 1분기 보고서,00139764,71276337161,67726039578,3550297583
파워로직스,2021년 1분기 보고서,00269612,211048025416,164515753296,46532272120
자화전자,2021년 1분기 보고서,00146861,189232548604,75770148844,113462399760
퍼스텍,2021년 1분기 보고서,00148522,106663000327,154343464517,-47680464190
신흥,2021년 1분기 보고서,00173795,46157753476,29794893678,16362859798
영화테크,2021년 1분기 보고서,00659976,37222735234,12777179978,24445555256
휴온스글로벌,2021년 1분기 보고서,00228059,23017625666,85907666886,-62890041220
경방,2021년 1분기 보고서,00101628,51234522724,457367091238,-406132568514
한솔홈데코,2021년 1분기 보고서,00203582,81287972590,122099310056,-40811337466
이에스에이,2021년 1분기 보고서,00347877,570596421,3146201753,-2575605332
넥스트BT,2021년 1분기 보고서,00384717,90283273594,-62162131645,152445405239
와토스코리아,2021년 1분기 보고서,00455875,56380930353,4876507061,51504423292
동국알앤에스,2021년 1분기 보고서,00472890,43593448444,42425071029,1168377415
에이치시티,2021년 1분기 보고서,00527464,25800893128,23531402910,2269490218
삼양사,2021년 1분기 보고서,00896285,757779000000,981066000000,-223287000000
디와이피엔에프,2021년 1분기 보고서,00602136,78059129230,66682157800,11376971430
타이거일렉,2021년 1분기 보고서,00617314,21699482049,20438790560,1260691489
네오위즈,2021년 1분기 보고서,00628860,178653696093,53158300104,125495395989
강스템바이오텍,2021년 1분기 보고서,01025644,35043481970,16315651538,18727830432
지엔원에너지,2021년 1분기 보고서,01228515,31349024535,6346438821,25002585714
포인트엔지니어링,2021년 1분기 보고서,01179608,48572626957,26170797445,22401829512
캐리소프트,2021년 1분기 보고서,01267222,4912074017,2694196541,2217877476
한국특강,2021년 1분기 보고서,00124090,170063287406,277983433815,-107920146409
현대코퍼레이션홀딩스,2021년 1분기 보고서,01108099,75541561237,35153018765,40388542472
지투알,2021년 1분기 보고서,00140168,29461256304,18360496171,11100760133
아이텍,2021년 1분기 보고서,00626011,63039495318,62270514361,768980957
티에이치엔,2021년 1분기 보고서,00118965,121164762476,182070820627,-60906058151
동우팜투테이블,2021년 1분기 보고서,00228712,107649932506,97284612495,10365320011
더블유게임즈,2021년 1분기 보고서,01010110,654480773899,9187251000,645293522899
에이치엘사이언스,2021년 1분기 보고서,01011438,81793411879,13320796682,68472615197
인포바인,2021년 1분기 보고서,00491415,71683017604,3970554721,67712462883
SCI평가정보,2021년 1분기 보고서,00260745,16519445065,8598197268,7921247797
네패스아크,2021년 1분기 보고서,01368354,60837762440,125986249707,-65148487267
두산퓨얼셀,2021년 1분기 보고서,01412725,621452789714,261071195948,360381593766
링크제니시스,2021년 1분기 보고서,01109955,40310809860,7823498860,32487311000
현대홈쇼핑,2021년 1분기 보고서,00412597,615991279673,307187246206,308804033467
판타지오,2021년 1분기 보고서,00231691,11830850673,5415128758,6415721915
한국전자홀딩스,2021년 1분기 보고서,00159254,14463312965,3691925894,10771387071
DB,2021년 1분기 보고서,00163345,93904796624,157242529566,-63337732942
비츠로셀,2021년 1분기 보고서,00154718,107808308280,36828853423,70979454857
웹케시,2021년 1분기 보고서,00323868,35650853202,37453483147,-1802629945
제일전기공업,2021년 1분기 보고서,00148470,77691680728,32202756903,45488923825
파멥신,2021년 1분기 보고서,00972293,80549601107,97644580831,-17094979724
상아프론테크,2021년 1분기 보고서,00181299,108211031064,92210410868,16000620196
씨젠,2021년 1분기 보고서,00788773,858877001405,406818819612,452058181793
동남합성,2021년 1분기 보고서,00115065,35399618754,33912824412,1486794342
코리아에프티,2021년 1분기 보고서,00803425,133365131797,150698702915,-17333571118
에스트래픽,2021년 1분기 보고서,01014055,50925349864,61493895160,-10568545296
네오팜,2021년 1분기 보고서,00551920,121656493467,22695295639,98961197828
아이씨디,2021년 1분기 보고서,00298377,128009612271,49572309353,78437302918
오르비텍,2021년 1분기 보고서,00297989,63312761341,52920303126,10392458215
이루온,2021년 1분기 보고서,00390514,26625072673,12386050936,14239021737
이오플로우,2021년 1분기 보고서,01274310,49365301312,34676747577,14688553735
이랜시스,2021년 1분기 보고서,01199189,28561247560,19118073358,9443174202
레이,2021년 1분기 보고서,00828761,57024289995,23026122015,33998167980
올리패스,2021년 1분기 보고서,01070149,46338634804,16266741012,30071893792
인탑스,2021년 1분기 보고서,00226866,289807019102,98257107210,191549911892
테크윙,2021년 1분기 보고서,00535676,169739914841,187581351973,-17841437132
케이피티유,2021년 1분기 보고서,00357607,15492675823,31086823733,-15594147910
티움바이오,2021년 1분기 보고서,01335930,65671016177,2192684251,63478331926
한국화장품,2021년 1분기 보고서,00823429,24570804920,11122720860,13448084060
대주산업,2021년 1분기 보고서,00112457,28036876199,35436225735,-7399349536
마니커에프앤지,2021년 1분기 보고서,00770312,53719425695,49947420987,3772004708
상신이디피,2021년 1분기 보고서,00480783,60412653800,64033293078,-3620639278
환인제약,2021년 1분기 보고서,00166573,218903878669,33797361734,185106516935
유니켐,2021년 1분기 보고서,00137207,90123426219,107243802610,-17120376391
국전약품,2021년 1분기 보고서,01329957,42864511365,28185714718,14678796647
엔지켐생명과학,2021년 1분기 보고서,00606886,130820254815,54406457587,76413797228
티케이케미칼,2021년 1분기 보고서,00693554,206173337368,434287437220,-228114099852
미코,2021년 1분기 보고서,00366942,48482989329,97868000569,-49385011240
광명전기,2021년 1분기 보고서,00103662,76003217211,45251602445,30751614766
크리스탈지노믹스,2021년 1분기 보고서,00407814,113359315675,35449150550,77910165125
엠에스오토텍,2021년 1분기 보고서,00259545,61857391788,283264152840,-221406761052
SBS미디어홀딩스,2021년 1분기 보고서,00650629,34716773526,2325482774,32391290752
켐온,2021년 1분기 보고서,01070857,43331116692,17791904402,25539212290
지노믹트리,2021년 1분기 보고서,01108248,41358322325,9993107500,31365214825
메가엠디,2021년 1분기 보고서,00807555,49632257199,50377256983,-744999784
한독,2021년 1분기 보고서,00161046,472375509926,288073370113,184302139813
샘표,2021년 1분기 보고서,00130091,37717098583,8068297660,29648800923
노바텍,2021년 1분기 보고서,01259232,45744567473,7027536675,38717030798
SPC삼립,2021년 1분기 보고서,00125530,203495702198,633510211197,-430014508999
제놀루션,2021년 1분기 보고서,01062177,69608002835,22785251913,46822750922
덕산하이메탈,2021년 1분기 보고서,00471068,45138403498,25081311717,20057091781
미원상사,2021년 1분기 보고서,00121932,148267900876,61531911200,86735989676
웰크론한텍,2021년 1분기 보고서,00487546,44241761159,9990051000,34251710159
리메드,2021년 1분기 보고서,01275665,45453138603,49065947272,-3612808669
삼정펄프,2021년 1분기 보고서,00128227,129501572708,22725289387,106776283321
인터로조,2021년 1분기 보고서,00604426,104659135155,61857536916,42801598239
천보,2021년 1분기 보고서,00897752,75953621612,9970904666,65982716946
에프엔에스테크,2021년 1분기 보고서,00476036,33565499239,31907604727,1657894512
압타머사이언스,2021년 1분기 보고서,01265251,34225814466,2157488466,32068326000
아이에이,2021년 1분기 보고서,00252269,22765783384,25766922229,-3001138845
샘표식품,2021년 1분기 보고서,01167056,141541387173,76221481238,65319905935
삼익악기,2021년 1분기 보고서,00127857,46196811977,196789552588,-150592740611
신테카바이오,2021년 1분기 보고서,01344336,41321989598,4367461298,36954528300
녹십자셀,2021년 1분기 보고서,00198378,50151778080,67575647237,-17423869157
풍산,2021년 1분기 보고서,00684714,1090517874169,978524969186,111992904983
캐스텍코리아,2021년 1분기 보고서,00302582,106105025425,141206444099,-35101418674
대림제지,2021년 1분기 보고서,00109781,50722800037,54786953578,-4064153541
이구산업,2021년 1분기 보고서,00145464,164114920400,176426568662,-12311648262
휴마시스,2021년 1분기 보고서,01042979,51615827554,19031390471,32584437083
티라유텍,2021년 1분기 보고서,01309388,14477772287,8961768875,5516003412
동방아그로,2021년 1분기 보고서,00115384,155570217148,62621931203,92948285945
한창,2021년 1분기 보고서,00163716,39985039741,37908802711,2076237030
위더스제약,2021년 1분기 보고서,00765851,74674580570,30387104278,44287476292
롯데정보통신,2021년 1분기 보고서,01262032,198729572475,152649487687,46080084788
얼라인드,2021년 1분기 보고서,01073678,15666560904,6188188121,9478372783
에스제이엠홀딩스,2021년 1분기 보고서,00181943,13904571905,14846033052,-941461147
아이퀘스트,2021년 1분기 보고서,01146822,43653117014,8752786421,34900330593
엔에스,2021년 1분기 보고서,01020843,80886083338,62059423033,18826660305
네온테크,2021년 1분기 보고서,01325429,26625083922,35214757605,-8589673683
아세아,2021년 1분기 보고서,00138701,28929147042,39309928256,-10380781214
파커스,2021년 1분기 보고서,00384762,45252986152,16093581775,29159404377
오스템임플란트,2021년 1분기 보고서,00341916,368551108406,556288207702,-187737099296
에스제이그룹,2021년 1분기 보고서,01222432,78337653316,36824208099,41513445217
미원에스씨,2021년 1분기 보고서,01234297,227813107128,66089900054,161723207074
대모,2021년 1분기 보고서,00450995,33721929263,32876264668,845664595
더블유에스아이,2021년 1분기 보고서,01318261,27892777475,3058700801,24834076674
엔바이오니아,2021년 1분기 보고서,00964595,14293741587,7926733784,6367007803
라파스,2021년 1분기 보고서,01058101,25435032817,10929104258,14505928559
케이엔제이,2021년 1분기 보고서,00769158,35883727788,62559154318,-26675426530
와이엔텍,2021년 1분기 보고서,00190756,32182666221,83635239943,-51452573722
에이텍티앤,2021년 1분기 보고서,01099861,10832223592,6498176415,4334047177
영원무역,2021년 1분기 보고서,00776820,447483696203,469530421774,-22046725571
디케이앤디,2021년 1분기 보고서,00892526,27090733081,7544800769,19545932312
레이크머티리얼즈,2021년 1분기 보고서,01255652,38486607775,52184567363,-13697959588
대원제약,2021년 1분기 보고서,00111999,128352108148,143081251921,-14729143773
티앤엘,2021년 1분기 보고서,00608440,46610820348,10182758805,36428061543
에스피지,2021년 1분기 보고서,00220686,125109839541,127567161452,-2457321911
웰크론,2021년 1분기 보고서,00362159,44283886128,55213826806,-10929940678
수산아이앤티,2021년 1분기 보고서,00577016,24506554053,4598907688,19907646365
테스,2021년 1분기 보고서,00524421,224696727128,72319355333,152377371795
엠투엔,2021년 1분기 보고서,00143226,9205831690,47513610069,-38307778379
인선이엔티,2021년 1분기 보고서,00375931,91467195730,114302128095,-22834932365
어보브반도체,2021년 1분기 보고서,00591441,108743507993,43305461727,65438046266
휴비츠,2021년 1분기 보고서,00398668,50333653060,67948672965,-17615019905
케이엔더블유,2021년 1분기 보고서,00606664,9875590676,11518969054,-1643378378
미래생명자원,2021년 1분기 보고서,01071944,37266213215,19849764254,17416448961
씨에스베어링,2021년 1분기 보고서,00765462,56613060234,79066252666,-22453192432
휴스틸,2021년 1분기 보고서,00156488,231912166714,171464104481,60448062233
소룩스,2021년 1분기 보고서,00605522,34066469392,21516001440,12550467952
덕우전자,2021년 1분기 보고서,00571298,58127996053,53196579005,4931417048
태평양물산,2021년 1분기 보고서,00154329,210657006846,415544458469,-204887451623
엘디티,2021년 1분기 보고서,00540571,8439459314,2122711869,6316747445
아미노로직스,2021년 1분기 보고서,00466428,33888887564,5033954900,28854932664
케이씨티,2021년 1분기 보고서,00441447,3827186601,19963419307,-16136232706
대창,2021년 1분기 보고서,00112651,238025250962,297388716580,-59363465618
알서포트,2021년 1분기 보고서,00838962,31907121657,10504165864,21402955793
에이비엘바이오,2021년 1분기 보고서,01256864,68999237843,8721866445,60277371398
삼화네트웍스,2021년 1분기 보고서,00301112,26295714448,5611527809,20684186639
비아트론,2021년 1분기 보고서,00610083,120364918723,36315429313,84049489410
흥국에프엔비,2021년 1분기 보고서,00916516,41493221768,26894869626,14598352142
윈팩,2021년 1분기 보고서,00536286,16718368700,80680552327,-63962183627
동양,2021년 1분기 보고서,00117337,214612442196,128041666186,86570776010
서울식품공업,2021년 1분기 보고서,00130879,25499187830,49472012809,-23972824979
그린플러스,2021년 1분기 보고서,00602279,32715239466,4803871000,27911368466
우리손에프앤지,2021년 1분기 보고서,00413417,64728827567,67072298205,-2343470638
오로스테크놀로지,2021년 1분기 보고서,01016479,66870977284,15927480498,50943496786
바디텍메드,2021년 1분기 보고서,01046708,107466963836,30005153995,77461809841
엠아이텍,2021년 1분기 보고서,00531829,47675590303,14069736810,33605853493
하나마이크론,2021년 1분기 보고서,00445054,145579283443,333645724715,-188066441272
영진약품,2021년 1분기 보고서,00141149,102141277462,79459803098,22681474364
쿠쿠홈시스,2021년 1분기 보고서,01267684,314539611872,146962126190,167577485682
체리부로,2021년 1분기 보고서,00216434,53966965383,147437471959,-93470506576
모비릭스,2021년 1분기 보고서,01210190,56719288334,6212645397,50506642937
현대그린푸드,2021년 1분기 보고서,00105280,374483460000,379707140000,-5223680000
유진기업,2021년 1분기 보고서,00184667,377375548060,730781357829,-353405809769
미디어젠,2021년 1분기 보고서,01190124,14415518483,13607424015,808094468
바이오니아,2021년 1분기 보고서,00326731,107481075673,52550266720,54930808953
동성화인텍,2021년 1분기 보고서,00231105,135080316465,135453684629,-373368164
신진에스엠,2021년 1분기 보고서,00577380,41297254429,31208828439,10088425990
티플랙스,2021년 1분기 보고서,00497631,70792342551,49689090375,21103252176
힘스,2021년 1분기 보고서,00556712,40621033596,5656118000,34964915596
국도화학,2021년 1분기 보고서,00104388,482555189165,454707958966,27847230199
뉴트리,2021년 1분기 보고서,01214248,56686453405,29632071327,27054382078
하이골드3호,2021년 1분기 보고서,00905316,62240,-58183552083,58183614323
오리온,2021년 1분기 보고서,01238169,184849059920,421037229124,-236188169204
아이진,2021년 1분기 보고서,00945457,41289165450,-71372447464,112661612914
삼륭물산,2021년 1분기 보고서,00125488,23576737291,28437928247,-4861190956
한일단조,2021년 1분기 보고서,00162832,71501802664,112179428460,-40677625796
아톤,2021년 1분기 보고서,00595182,38291633233,7829925449,30461707784
조광페인트,2021년 1분기 보고서,00148920,101143245071,154638228559,-53494983488
선익시스템,2021년 1분기 보고서,00327819,61861505287,19917641055,41943864232
유비쿼스,2021년 1분기 보고서,01203376,121505468796,37575982681,83929486115
동아엘텍,2021년 1분기 보고서,00489243,115508075006,48292075401,67215999605
디지캡,2021년 1분기 보고서,00681373,9905056231,14174114701,-4269058470
안트로젠,2021년 1분기 보고서,00631837,66632798464,26367040734,40265757730
이수앱지스,2021년 1분기 보고서,00526872,44605860853,18689374353,25916486500
에스디생명공학,2021년 1분기 보고서,01099667,59108325453,53774304410,5334021043
에스제이엠,2021년 1분기 보고서,00815369,58904229268,18352766316,40551462952
정다운,2021년 1분기 보고서,01047415,77813972935,73738422129,4075550806
일진파워,2021년 1분기 보고서,00485177,46601066468,34234701095,12366365373
켐트로닉스,2021년 1분기 보고서,00371485,131796402678,180332816474,-48536413796
한빛소프트,2021년 1분기 보고서,00348292,9005957972,21051730883,-12045772911
우원개발,2021년 1분기 보고서,00363246,46347200032,54059706806,-7712506774
미스터블루,2021년 1분기 보고서,01047840,23325306649,11228752268,12096554381
티로보틱스,2021년 1분기 보고서,00867098,32740540925,37924398795,-5183857870
극동유화,2021년 1분기 보고서,00105156,109634997365,105545481686,4089515679
삼아제약,2021년 1분기 보고서,00126788,91595851132,15546002768,76049848364
EDGC,2021년 1분기 보고서,01182550,83853810541,102091633978,-18237823437
부산도시가스,2021년 1분기 보고서,00123967,378238611787,420688862773,-42450250986
티피씨글로벌,2021년 1분기 보고서,00578538,25492335986,25228285541,264050445
디젠스,2021년 1분기 보고서,00576789,32060837708,43715552835,-11654715127
셀루메드,2021년 1분기 보고서,00310156,18254560784,13945722467,4308838317
KPX홀딩스,2021년 1분기 보고서,00587466,160640442562,54084715756,106555726806
혜인,2021년 1분기 보고서,00165343,120703106175,102089310999,18613795176
인터파크,2021년 1분기 보고서,00244561,180101457910,237567950283,-57466492373
쎄트렉아이,2021년 1분기 보고서,00449254,105956353557,72878122802,33078230755
동일철강,2021년 1분기 보고서,00172945,47726118685,55754997933,-8028879248
케이티,2021년 1분기 보고서,00190321,7287308000000,14681300000000,-7393992000000
지니뮤직,2021년 1분기 보고서,00223762,170834618527,86358605417,84476013110
KT서브마린,2021년 1분기 보고서,00225742,69517632189,13567537051,55950095138
미래산업,2021년 1분기 보고서,00197759,46480805050,41175085110,5305719940
제일테크노스,2021년 1분기 보고서,00148595,66819825878,84374989162,-17555163284
서울도시가스,2021년 1분기 보고서,00130684,882205300168,675571616640,206633683528
NICE,2021년 1분기 보고서,00158316,450879967109,18941150000,431938817109
앤디포스,2021년 1분기 보고서,00942131,100765781598,26604785965,74160995633
엠게임,2021년 1분기 보고서,00397058,33233187423,12498941196,20734246227
크리스에프앤씨,2021년 1분기 보고서,00522007,230074585687,90984333288,139090252399
바이오솔루션,2021년 1분기 보고서,00560982,41244282693,3593595243,37650687450
국순당,2021년 1분기 보고서,00256715,65859095614,8929152000,56929943614
제일기획,2021년 1분기 보고서,00148276,700343820029,508273072941,192070747088
삼성전기,2021년 1분기 보고서,00126371,2744336602820,1275020140053,1469316462767
EMW,2021년 1분기 보고서,00479705,20931242459,19636704313,1294538146
휴켐스,2021년 1분기 보고서,00426086,496729348077,221001767043,275727581034
전진바이오팜,2021년 1분기 보고서,00632793,6516607420,5029553805,1487053615
삼성공조,2021년 1분기 보고서,00126201,166920972433,25814701552,141106270881
KG ETS,2021년 1분기 보고서,00366137,45900424612,182754026452,-136853601840
조선내화,2021년 1분기 보고서,00148984,246543699541,358468309682,-111924610141
효성 ITX,2021년 1분기 보고서,00414850,58483483829,114043444677,-55559960848
팬오션,2021년 1분기 보고서,00122737,674265000000,2081817000000,-1407552000000
코렌,2021년 1분기 보고서,00477257,26192634030,50321241662,-24128607632
카이노스메드,2021년 1분기 보고서,01263527,12095678420,20445130094,-8349451674
케이씨씨글라스,2021년 1분기 보고서,01428203,767092718472,427588921356,339503797116
삼양홀딩스,2021년 1분기 보고서,00126937,365089000000,259373000000,105716000000
코웨이,2021년 1분기 보고서,00170558,1048043370457,1612950636558,-564907266101
에이치엘비제약,2021년 1분기 보고서,00336817,63129568831,61397034004,1732534827
한국쉘석유,2021년 1분기 보고서,00158149,129011501994,67741972901,61269529093
휴온스블러썸,2021년 1분기 보고서,01185566,36947375394,62499085382,-25551709988
테스나,2021년 1분기 보고서,00563545,59082434989,243175887592,-184093452603
HDC,2021년 1분기 보고서,00164636,165202468278,183911598372,-18709130094
HDC현대EP,2021년 1분기 보고서,00357935,307261078589,240413806105,66847272484
한솔제지,2021년 1분기 보고서,01060744,554911789360,1093490230026,-538578440666
YG PLUS,2021년 1분기 보고서,00249247,59038420092,21365801212,37672618880
한일화학,2021년 1분기 보고서,00267979,93082816568,60294779864,32788036704
엔에스쇼핑,2021년 1분기 보고서,00406392,128985353278,438604900834,-309619547556
성호전자,2021년 1분기 보고서,00317210,56149508883,70103937680,-13954428797
빛샘전자,2021년 1분기 보고서,00359261,39967195997,9354420351,30612775646
아이크래프트,2021년 1분기 보고서,00405719,29131489835,19824121236,9307368599
케이사인,2021년 1분기 보고서,01003040,24965975563,7067125700,17898849863
스타모빌리티,2021년 1분기 보고서,00923899,21875843234,31457895548,-9582052314
고려제약,2021년 1분기 보고서,00103015,67676345848,15772206810,51904139038
진매트릭스,2021년 1분기 보고서,00552992,20061918601,5097379218,14964539383
에스티팜,2021년 1분기 보고서,00871833,221442269109,147220487713,74221781396
금호석유화학,2021년 1분기 보고서,00106368,1561444493269,1497732758489,63711734780
대한화섬,2021년 1분기 보고서,00113544,73722657336,121303078522,-47580421186
세동,2021년 1분기 보고서,00133663,22761207230,82552332715,-59791125485
대양금속,2021년 1분기 보고서,00111111,79724705085,38439151899,41285553186
선데이토즈,2021년 1분기 보고서,00815767,131858309643,15491244183,116367065460
피피아이,2021년 1분기 보고서,00403766,17580506557,16970792142,609714415
남화산업,2021년 1분기 보고서,00245694,39164405126,14853697964,24310707162
위메이드,2021년 1분기 보고서,00444329,242510345604,53938079283,188572266321
휘닉스소재,2021년 1분기 보고서,00369569,24085784384,17008958586,7076825798
이월드,2021년 1분기 보고서,00540605,56680931336,85846480224,-29165548888
솔루에타,2021년 1분기 보고서,00624518,45550983621,61854211746,-16303228125
아모레퍼시픽,2021년 1분기 보고서,00583424,1479477308109,465662052190,1013815255919
아모레퍼시픽그룹,2021년 1분기 보고서,00154462,454645217808,85457217085,369188000723
한온시스템,2021년 1분기 보고서,00161125,1339815662560,3440616264170,-2100800601610
유니온,2021년 1분기 보고서,00144252,45090709446,80676308195,-35585598749
티에스이,2021년 1분기 보고서,00372226,105961992633,30049342262,75912650371
핸디소프트,2021년 1분기 보고서,00793155,60476677178,6617331690,53859345488
현대바이오랜드,2021년 1분기 보고서,00347062,53786562014,30838063458,22948498556
휴메딕스,2021년 1분기 보고서,00614478,73018724266,41156134892,31862589374
두산인프라코어,2021년 1분기 보고서,00344287,1888178075824,3981705911738,-2093527835914
한섬,2021년 1분기 보고서,00188089,625907213085,12315000000,613592213085
에스엘바이오닉스,2021년 1분기 보고서,00957568,22403378897,31227320489,-8823941592
현대제철,2021년 1분기 보고서,00145880,8239425262794,16165052525092,-7925627262298
부산산업,2021년 1분기 보고서,00124027,9760726129,8007824694,1752901435
제이엘케이,2021년 1분기 보고서,01153293,15888864188,15957776632,-68912444
한전기술,2021년 1분기 보고서,00159209,248287008362,211221663786,37065344576
무림SP,2021년 1분기 보고서,00121507,179292215890,130737486980,48554728910
삼천리자전거,2021년 1분기 보고서,00128607,96194400390,48913927141,47280473249
팜젠사이언스,2021년 1분기 보고서,00135050,63417198903,51107503601,12309695302
유니온머티리얼,2021년 1분기 보고서,00369833,82311336614,76240768518,6070568096
LG화학,2021년 1분기 보고서,00356361,7292096000000,11193563000000,-3901467000000
쏠리드,2021년 1분기 보고서,00364403,89002233115,147775537841,-58773304726
진에어,2021년 1분기 보고서,00653024,113905162116,464575385746,-350670223630
현대퓨처넷,2021년 1분기 보고서,00403632,288038395634,124312446287,163725949347
참엔지니어링,2021년 1분기 보고서,00153621,72080592280,90923799958,-18843207678
휴맥스홀딩스,2021년 1분기 보고서,00219440,4488450045,22047187488,-17558737443
제이시스메디칼,2021년 1분기 보고서,01267602,36204386634,18507688090,17696698544
인피니티엔티,2021년 1분기 보고서,00125725,16254413061,27926255223,-11671842162
휴먼엔,2021년 1분기 보고서,00205687,17405845580,7179087002,10226758578
레드로버,2021년 1분기 보고서,00364795,16571914647,14685815438,1886099209
이디티,2021년 1분기 보고서,01063884,35948561256,2291104589,33657456667
티비씨,2021년 1분기 보고서,00204642,70890887805,6383423812,64507463993
남양유업,2021년 1분기 보고서,00107598,475236230014,210329181539,264907048475
E1,2021년 1분기 보고서,00165583,1119325385720,1743349292369,-624023906649
코오롱생명과학,2021년 1분기 보고서,00525642,132544273587,209425407924,-76881134337
한세실업,2021년 1분기 보고서,00728638,638138859117,469879315646,168259543471
한세예스24홀딩스,2021년 1분기 보고서,00161976,18415583833,95310388440,-76894804607
한화에어로스페이스,2021년 1분기 보고서,00126566,1690148198706,2906017426735,-1215869228029
노바렉스,2021년 1분기 보고서,00811372,105300228558,112700317937,-7400089379
현대건설,2021년 1분기 보고서,00164478,8275435000000,6476342000000,1799093000000
삼영화학공업,2021년 1분기 보고서,00127255,22718634869,23345050806,-626415937
넷게임즈,2021년 1분기 보고서,01096341,78344447527,30965583725,47378863802
오텍,2021년 1분기 보고서,00397289,57549728962,78261351493,-20711622531
메가스터디,2021년 1분기 보고서,00422284,108420746903,33544721813,74876025090
노랑풍선,2021년 1분기 보고서,00632845,48117483312,2382825000,45734658312
종근당,2021년 1분기 보고서,00992871,570903489239,370295226659,200608262580
대우건설,2021년 1분기 보고서,00124540,5792827623555,6414588428668,-621760805113
조이시티,2021년 1분기 보고서,00397252,52384787945,22383241500,30001546445
STX엔진,2021년 1분기 보고서,00480455,385789000000,505177000000,-119388000000
에이피티씨,2021년 1분기 보고서,00544577,112503313698,36318501062,76184812636
두산밥캣,2021년 1분기 보고서,01032486,137668622000,227475966000,-89807344000
엔시스,2021년 1분기 보고서,01310773,51863503367,13360021773,38503481594
국보디자인,2021년 1분기 보고서,00253985,110758482877,91401847777,19356635100
참좋은여행,2021년 1분기 보고서,00606770,72303184680,5247868885,67055315795
에이치피오,2021년 1분기 보고서,01068737,29428066281,11475597352,17952468929
대한방직,2021년 1분기 보고서,00112970,100301028011,83694850698,16606177313
동운아나텍,2021년 1분기 보고서,00695969,55361633940,36786457122,18575176818
루멘스,2021년 1분기 보고서,00406329,96597515944,89529902105,7067613839
ISC,2021년 1분기 보고서,00572905,75032272195,53893958559,21138313636
아이즈비전,2021년 1분기 보고서,00200910,42295036723,16319519105,25975517618
한화,2021년 1분기 보고서,00160588,1867198000000,4576317000000,-2709119000000
에이스테크,2021년 1분기 보고서,00556907,137753725508,192344396668,-54590671160
넥스트사이언스,2021년 1분기 보고서,00169048,29846929783,37852843381,-8005913598
상상인,2021년 1분기 보고서,00306162,34557715668,22458572475,12099143193
줌인터넷,2021년 1분기 보고서,01128622,23887585733,6590674130,17296911603
금호타이어,2021년 1분기 보고서,00481454,876683709707,1884397831206,-1007714121499
F&F 홀딩스,2021년 1분기 보고서,00126487,637283891047,2356716561874,-1719432670827
엔에스엔,2021년 1분기 보고서,00180865,21934021996,9843627509,12090394487
CMG제약,2021년 1분기 보고서,00380429,146209548928,13000115396,133209433532
GST,2021년 1분기 보고서,00540863,97495034019,37179534799,60315499220
일지테크,2021년 1분기 보고서,00146560,59638661211,77757815341,-18119154130
포스코 ICT,2021년 1분기 보고서,00155212,390163811561,248908372671,141255438890
크로바하이텍,2021년 1분기 보고서,00260611,14643822816,7499910739,7143912077
한화시스템,2021년 1분기 보고서,00339391,1583890362100,1591743026365,-7852664265
삼강엠앤티,2021년 1분기 보고서,00480367,231864855872,385452055861,-153587199989
화승알앤에이,2021년 1분기 보고서,01532603,226310520417,354155785024,-127845264607
에너토크,2021년 1분기 보고서,00169215,18832601158,5744253752,13088347406
신세계푸드,2021년 1분기 보고서,00274933,254320094196,602121757652,-347801663456
이랜텍,2021년 1분기 보고서,00206659,108913724141,94822677289,14091046852
유앤아이,2021년 1분기 보고서,00346610,19106581896,30534711851,-11428129955
다우기술,2021년 1분기 보고서,00176914,374761412096,441552845421,-66791433325
다우데이타,2021년 1분기 보고서,00238782,224752070900,331440703158,-106688632258
한국파마,2021년 1분기 보고서,00187770,48149322867,32965509841,15183813026
디와이,2021년 1분기 보고서,00117179,12975105082,4899373385,8075731697
삼일,2021년 1분기 보고서,00127909,16091526771,47526680043,-31435153272
대동기어,2021년 1분기 보고서,00109310,92846448675,155881878718,-63035430043
화성밸브,2021년 1분기 보고서,00217743,63211005520,27596727164,35614278356
쌍용정보통신,2021년 1분기 보고서,00138303,46081012044,75265324891,-29184312847
씨큐브,2021년 1분기 보고서,00520610,41404858295,27921338636,13483519659
지니틱스,2021년 1분기 보고서,01318933,29086105933,10015036678,19071069255
현진소재,2021년 1분기 보고서,00188715,15040939512,114906046649,-99865107137
대양제지,2021년 1분기 보고서,00111227,52180299468,34789815893,17390483575
피에이치씨,2021년 1분기 보고서,00410739,40368127838,7600669136,32767458702
윈스,2021년 1분기 보고서,00868705,73662981122,38955628246,34707352876
와이오엠,2021년 1분기 보고서,00370200,14905893835,10617307544,4288586291
효성화학,2021년 1분기 보고서,01316236,394834762628,1144146346207,-749311583579
롯데칠성음료,2021년 1분기 보고서,00120571,896859858948,2096537194428,-1199677335480
카카오게임즈,2021년 1분기 보고서,01137383,801658679357,7456009900,794202669457
JYP Ent.,2021년 1분기 보고서,00258689,97889381329,31326237818,66563143511
오이솔루션,2021년 1분기 보고서,00571483,127904040266,51828459951,76075580315
현대공업,2021년 1분기 보고서,00164502,111960063245,54117110444,57842952801
대우조선해양,2021년 1분기 보고서,00111704,5520984369802,6310339084826,-789354715024
동아쏘시오홀딩스,2021년 1분기 보고서,00116824,139144412546,306821790398,-167677377852
삼성엔지니어링,2021년 1분기 보고서,00126308,2275106616536,2628945777161,-353839160625
신라섬유,2021년 1분기 보고서,00135999,1890392653,17679220075,-15788827422
SK하이닉스,2021년 1분기 보고서,00164779,14272903000000,18156016000000,-3883113000000
로지시스,2021년 1분기 보고서,00238199,18691764092,8379057906,10312706186
효성티앤씨,2021년 1분기 보고서,01316227,473875460886,824742772428,-350867311542
주성엔지니어링,2021년 1분기 보고서,00252135,142361161336,317356664764,-174995503428
LG헬로비전,2021년 1분기 보고서,00222532,238186819920,257328460210,-19141640290
LG,2021년 1분기 보고서,00120021,3135541000000,2418720000000,716821000000
골프존,2021년 1분기 보고서,01067516,134510011966,138495824224,-3985812258
롯데케미칼,2021년 1분기 보고서,00165413,5363597522613,4328957551035,1034639971578
진원생명과학,2021년 1분기 보고서,00118521,88889250346,33815766079,55073484267
한프,2021년 1분기 보고서,00226228,49101556212,80389270848,-31287714636
티사이언티픽,2021년 1분기 보고서,00372688,28840024880,35579711825,-6739686945
에이비프로바이오,2021년 1분기 보고서,00620558,55279430486,19741605015,35537825471
한국정보통신,2021년 1분기 보고서,00159342,273065105000,139919108000,133145997000
선도전기,2021년 1분기 보고서,00131939,60390461885,82056118333,-21665656448
STX중공업,2021년 1분기 보고서,00406046,111396013480,248892666268,-137496652788
씨엔플러스,2021년 1분기 보고서,00660033,15219479114,18482581280,-3263102166
폴라리스우노,2021년 1분기 보고서,00663669,53583416419,8450163050,45133253369
세방전지,2021년 1분기 보고서,00133858,935776253386,279397284672,656378968714
케이티앤지,2021년 1분기 보고서,00244455,4803652485234,2358597733120,2445054752114
유비케어,2021년 1분기 보고서,00220057,90329398922,29461383826,60868015096
유테크,2021년 1분기 보고서,00923826,24927923136,3677372847,21250550289
국보,2021년 1분기 보고서,00104519,33352174871,46483790296,-13131615425
브이티지엠피,2021년 1분기 보고서,00150165,65317007921,75206662381,-9889654460
KPX생명과학,2021년 1분기 보고서,00532059,23529324610,11030347046,12498977564
세이브존I&C,2021년 1분기 보고서,00422895,75189330615,106405272301,-31215941686
스타플렉스,2021년 1분기 보고서,00405959,31659689271,49882660842,-18222971571
해성디에스,2021년 1분기 보고서,01032413,198418944064,168866437355,29552506709
SGA,2021년 1분기 보고서,00351579,19887480024,21095687705,-1208207681
대주전자재료,2021년 1분기 보고서,00177816,55847692124,112170787072,-56323094948
한국컴퓨터,2021년 1분기 보고서,00303396,70162737004,19727157211,50435579793
코센,2021년 1분기 보고서,00116426,22853313029,32368034106,-9514721077
지코,2021년 1분기 보고서,00147860,13989913508,54498462486,-40508548978
삼진,2021년 1분기 보고서,00173351,42069665464,15726008873,26343656591
GS홈쇼핑,2021년 1분기 보고서,00207755,763174116252,351321863316,411852252936
서울반도체,2021년 1분기 보고서,00130763,495472741683,266535050745,228937690938
제주항공,2021년 1분기 보고서,00555874,229838424811,954187267281,-724348842470
디지탈옵틱,2021년 1분기 보고서,00536329,38890513210,81207794580,-42317281370
와이어블,2021년 1분기 보고서,00250137,47403668204,67177123634,-19773455430
하이트론씨스템즈,2021년 1분기 보고서,00156150,51141473029,35409372465,15732100564
조광ILI,2021년 1분기 보고서,00291860,55168176580,55534966714,-366790134
이브이첨단소재,2021년 1분기 보고서,00533924,25739058130,54366882638,-28627824508
이스트아시아홀딩스,2021년 1분기 보고서,00799070,1252406245,50750476,1201655769
THQ,2021년 1분기 보고서,00623184,15344117873,14402101500,942016373
에치에프알,2021년 1분기 보고서,01108442,54675043107,58689622756,-4014579649
SK이노베이션,2021년 1분기 보고서,00631518,15979011518000,468569950000,15510441568000
에스엘,2021년 1분기 보고서,00125521,1072497264608,433853492638,638643771970
드림씨아이에스,2021년 1분기 보고서,00916826,43273202640,11807463313,31465739327
바텍,2021년 1분기 보고서,00264255,325254829278,234785660152,90469169126
한국앤컴퍼니,2021년 1분기 보고서,00160047,227550515279,103656339787,123894175492
셀레믹스,2021년 1분기 보고서,01114586,26842528565,1097935146,25744593419
에코프로비엠,2021년 1분기 보고서,01160363,506602850984,140696298215,365906552769
농심,2021년 1분기 보고서,00108241,718836252362,541580669788,177255582574
금강철강,2021년 1분기 보고서,00105475,101824515493,33985700267,67838815226
아세아제지,2021년 1분기 보고서,00138729,193396030902,90725333337,102670697565
아이마켓코리아,2021년 1분기 보고서,00360142,578839660871,427509811680,151329849191
삼성전자,2021년 1분기 보고서,00126380,78618052000000,61774498000000,16843554000000
SK바이오사이언스,2021년 1분기 보고서,01319899,1458196444438,419370091432,1038826353006
애머릿지,2021년 1분기 보고서,00781202,20224561,34542717,-14318156
씨앤티85,2021년 1분기 보고서,00318662,28159423270,37438883321,-9279460051
현대리바트,2021년 1분기 보고서,00300548,374211152032,323471762414,50739389618
위메이드맥스,2021년 1분기 보고서,00643656,16928801135,3973394298,12955406837
효성첨단소재,2021년 1분기 보고서,01316254,169689779620,738712304512,-569022524892
ES큐브,2021년 1분기 보고서,00175623,13935264006,15964558402,-2029294396
대상,2021년 1분기 보고서,00121941,1193080600009,1371011781336,-177931181327
제우스,2021년 1분기 보고서,00442570,113717298319,127613198252,-13895899933
두올,2021년 1분기 보고서,00119672,128371360046,115681998801,12689361245
신흥에스이씨,2021년 1분기 보고서,00807379,77026300182,105921422981,-28895122799
이노션,2021년 1분기 보고서,00565154,526843328373,285617343546,241225984827
케이씨텍,2021년 1분기 보고서,01261893,291783786914,54719672388,237064114526
현대자동차,2021년 1분기 보고서,00164742,54741237000000,1488993000000,53252244000000
버킷스튜디오,2021년 1분기 보고서,00378220,34813421236,91379531606,-56566110370
코스맥스엔비티,2021년 1분기 보고서,00656289,85520653697,177579307539,-92058653842
한라홀딩스,2021년 1분기 보고서,00299002,464114462392,848015168590,-383900706198
AP시스템,2021년 1분기 보고서,01203808,245086543399,243290949090,1795594309
원방테크,2021년 1분기 보고서,00304076,63893854139,23841022379,40052831760
이마트,2021년 1분기 보고서,00872984,13772193518250,3513831922381,10258361595869
경동도시가스,2021년 1분기 보고서,01208885,419239257041,425838760839,-6599503798
세코닉스,2021년 1분기 보고서,00351630,149968142713,209901627697,-59933484984
시큐브,2021년 1분기 보고서,00402110,30465728145,3804705609,26661022536
인포마크,2021년 1분기 보고서,00861997,32503072022,35093083753,-2590011731
KSS해운,2021년 1분기 보고서,00160232,61335180227,954049754546,-892714574319
코아시아,2021년 1분기 보고서,00271501,56450145251,81626138735,-25175993484
NAVER,2021년 1분기 보고서,00266961,2089381151171,2960309597841,-870928446670
강원랜드,2021년 1분기 보고서,00255619,1426168025915,388539094865,1037628931050
현대엘리베이터,2021년 1분기 보고서,00164724,929231096325,975105339808,-45874243483
흥아해운,2021년 1분기 보고서,00167208,63501972127,328229782916,-264727810789
한국항공우주,2021년 1분기 보고서,00309503,3272066700576,4011785245128,-739718544552
한국타이어앤테크놀로지,2021년 1분기 보고서,00937324,2083703315596,1911866543424,171836772172
현대미포조선,2021년 1분기 보고서,00164609,1939294638000,1185670726000,753623912000
신세계,2021년 1분기 보고서,00136378,574169555296,3971223869147,-3397054313851
SK디앤디,2021년 1분기 보고서,00508344,864482604110,1003611775517,-139129171407
에이씨티,2021년 1분기 보고서,00808068,34561516929,4076569882,30484947047
바른손,2021년 1분기 보고서,00122205,23269725819,11379757170,11889968649
써니전자,2021년 1분기 보고서,00138057,47899060586,2119630642,45779429944
우리조명,2021년 1분기 보고서,00155692,10557499319,32157826999,-21600327680
원익홀딩스,2021년 1분기 보고서,00216647,90568404018,216567908003,-125999503985
솔브레인홀딩스,2021년 1분기 보고서,00247975,1008680745802,10482028000,998198717802
EG,2021년 1분기 보고서,00261054,30029685249,57419185428,-27389500179
큐로홀딩스,2021년 1분기 보고서,00296324,24350646370,9026144497,15324501873
에이치엘비파워,2021년 1분기 보고서,00317487,24241650091,15132573900,9109076191
한국전자금융,2021년 1분기 보고서,00363769,190671684987,265479114041,-74807429054
드림어스컴퍼니,2021년 1분기 보고서,00364467,148209153890,76723605612,71485548278
제넨바이오,2021년 1분기 보고서,00408956,19553080035,35771324216,-16218244181
WI,2021년 1분기 보고서,00440712,28490114585,10383626298,18106488287
코스나인,2021년 1분기 보고서,00442455,12192358205,45689701867,-33497343662
칩스앤미디어,2021년 1분기 보고서,00579971,22527116135,7201666477,15325449658
지스마트글로벌,2021년 1분기 보고서,00673976,23764360717,46655956240,-22891595523
뉴지랩파마,2021년 1분기 보고서,00820389,116926942525,65671303116,51255639409
파마리서치,2021년 1분기 보고서,00970453,119646757105,39253325974,80393431131
더네이쳐홀딩스,2021년 1분기 보고서,01214743,149025111949,93492512046,55532599903
KTH,2021년 1분기 보고서,00260958,124091484948,78742463278,45349021670
유유제약,2021년 1분기 보고서,00144818,64294223310,32269919570,32024303740
디아이티,2021년 1분기 보고서,00576798,279356075983,151589861426,127766214557
한일시멘트,2021년 1분기 보고서,01319808,498259110176,731613286759,-233354176583
롯데푸드,2021년 1분기 보고서,00120508,1231152161314,978229717017,252922444297
우리로,2021년 1분기 보고서,00296005,23058040064,32836879914,-9778839850
삼성바이오로직스,2021년 1분기 보고서,00877059,1781745354686,1363758562226,417986792460
나이스정보통신,2021년 1분기 보고서,00264945,202141658761,87028044725,115113614036
파크시스템스,2021년 1분기 보고서,00244747,75416409432,53403919750,22012489682
아이센스,2021년 1분기 보고서,00550994,147659762221,75754565930,71905196291
다산네트웍스,2021년 1분기 보고서,00268251,55719487185,59741127953,-4021640768
맘스터치,2021년 1분기 보고서,01089855,51265062092,32894188849,18370873243
대교,2021년 1분기 보고서,00108913,200568229777,226316431635,-25748201858
동국제강,2021년 1분기 보고서,00114792,1524972318881,2975713445661,-1450741126780
아리온,2021년 1분기 보고서,00441128,14683330175,36067391464,-21384061289
GV,2021년 1분기 보고서,00455112,49726824973,61886499505,-12159674532
SGA솔루션즈,2021년 1분기 보고서,00988364,12488903990,15003161112,-2514257122
한화솔루션,2021년 1분기 보고서,00162461,3583529923079,4838177253640,-1254647330561
한국조선해양,2021년 1분기 보고서,00164830,10933352812000,16144989044000,-5211636232000
신화실업,2021년 1분기 보고서,00137809,48313007262,36255475570,12057531692
대원,2021년 1분기 보고서,00111838,280235830815,160956066205,119279764610
제이씨현시스템,2021년 1분기 보고서,00223513,90548028009,39116944882,51431083127
한솔홀딩스,2021년 1분기 보고서,00171636,60787597903,21726909366,39060688537
롯데하이마트,2021년 1분기 보고서,00158307,994567752410,1430265597630,-435697845220
SM C&C,2021년 1분기 보고서,00185046,184256520318,157568504092,26688016226
한국전력공사,2021년 1분기 보고서,00159193,8875435000000,60887654000000,-52012219000000
상지카일룸,2021년 1분기 보고서,00232007,72101330923,56441786511,15659544412
AJ네트웍스,2021년 1분기 보고서,00365387,166242235197,921683882660,-755441647463
한국코퍼레이션,2021년 1분기 보고서,00302078,19602988147,41776890800,-22173902653
컨버즈,2021년 1분기 보고서,00753643,9213065051,10440277752,-1227212701
뉴파워프라즈마,2021년 1분기 보고서,00521390,65764209294,94581556948,-28817347654
에이디테크놀로지,2021년 1분기 보고서,00657002,148718532683,79519497096,69199035587
엘브이엠씨,2021년 1분기 보고서,00838500,259400272,270232386,-10832114
